ܐܦܪܝܩܐ	Africa
ܝܦܢ	Giappone
ܐܡܪܝܩܐ ܬܝܡܢܝܬܐ	America Meridionale
ܢܘܪܒܝܓ	Norvegia
ܩܘܛܢܝܘܬܐ ܕܐܝܪܠܢܕ	Irlanda
ܡܓܪ	Ungheria
ܐܣܦܢܝܐ	Spagna
ܐܘܚܕܢܐ ܡܚܝܕܐ	Stati Uniti d'America
ܒܠܓܝܩܐ	Belgio
ܠܘܟܣܡܒܘܪܓ	Lussemburgo
ܬܒܝܠ	Universo
ܐܪܥܐ	Terra
ܡܘܬܐ	Morte
ܒܪ ܐܢܫܐ	Homo sapiens
ܓܘܪܓ ܘܐܫܝܢܓܛܘܢ	George Washington
ܦܝܢܠܢܕ	Finlandia
ܣܘܝܕ	Svezia
ܕܐܢܡܐܪܩ	Danimarca
ܦܘܠܢܕ	Polonia
ܠܬܘܢܝܐ	Lituania
ܐܝܛܠܝܐ	Italia
ܣܘܝܣܪܐ	Svizzera
ܢܡܣܐ	Austria
ܝܘܢ	Grecia
ܛܘܪܩܝܐ	Turchia
ܦܘܪܛܘܓܠ	Portogallo
ܐܘܪܘܦܐ (ܝܒܫܬܐ)	Europa
ܐܣܝܐ (ܝܒܫܬܐ)	Asia
ܐܡܪܝܩܐ ܓܪܒܝܝܬܐ	America del Nord
ܐܢܛܐܪܩܛܝܩܐ	Antartide
ܘܝܩܝܦܕܝܐ	Wikipedia
ܗܘܠܢܕܐ	Paesi Bassi
ܢܝܘ ܝܘܪܩ (ܡܕܝܢܬܐ)	New York
ܘܐܫܢܓܛܘܢ (ܐܪܫܟܝܬܐ)	Washington
ܒܪܠܝܢ	Berlino
ܚܫܘܒܐ (ܡܐܟܢܐ)	Computer
ܒܪܢ	Berna
ܬܣܝܪܝܟ	Zurigo
ܐܢܛܪܢܛ	Internet
ܒܪܐܩ ܐܘܒܐܡܐ	Barack Obama
ܠܘܢܕܘܢ	Londra
ܐܠܟܣܢܕܪܝܐ	Alessandria d'Egitto
ܚܙܘܪܐ	Mela
ܦܐܪܝܣ	Parigi
ܡܟܣܝܩܘ	Messico
ܐܘܩܝܢܘܣ ܐܛܠܢܛܝܐ	Oceano Atlantico
ܐܘܩܝܢܘܣ ܫܝܢܝܐ	Oceano Pacifico
ܒܘܣܛܘܢ	Boston
ܬܪܝܢܒܫܒܐ	Lunedì
ܟܢܘܢ ܒ	Gennaio
ܫܒܛ	Febbraio
ܐܕܪ	Marzo
ܟܘܫ	Etiopia
ܢܝܣܢ	Aprile
ܐܝܪ	Maggio
ܚܙܝܪܢ	Giugno
ܬܡܘܙ	Luglio
ܐܒ	Agosto
ܐܝܠܘܠ	Settembre
ܬܫܪܝܢ ܐ	Ottobre
ܬܫܪܝܢ ܒ	Novembre
ܟܢܘܢ ܐ	Dicembre
ܬܠܬܒܫܒܐ	Martedì
ܐܪܒܥܒܫܒܐ	Mercoledì
ܚܡܫܒܫܒܐ	Giovedì
ܥܪܘܒܬܐ	Venerdì
ܫܒܬܐ (ܙܒܢܐ)	Sabato
ܚܕܒܫܒܐ	Domenica
ܐܪܝܐ	Panthera leo
ܦܪܢܣܐ	Francia
ܟܠܒܐ	Canis lupus familiaris
ܡܠܟܘܬܐ ܡܚܝܕܬܐ	Regno Unito
ܩܛܐ	Felis silvestris catus
ܩܘܛܢܝܘܬܐ ܥܡܡܝܬܐ ܕܨܝܢ	Cina
ܠܫܢܐ ܦܪܢܣܝܐ	Lingua francese
ܒܪܐܙܝܠ	Brasile
ܪܘܣܝܐ	Russia
ܝܡܐ	Mare
ܝܡܐ ܐܘܟܡܐ	Mar Nero
Π	Pi (lettera greca)
ܐܠܒܐܡܐ	Alabama
ܣܐܘ ܦܐܘܠܘ	San Paolo (Brasile)
ܩܝܒܩ (ܗܘܦܪܟܝܐ)	Québec (provincia)
ܓܪܡܢ	Germania
ܒܠܐܪܘܣ	Bielorussia
ܠܫܢܐ ܓܪܡܢܝܐ	Lingua tedesca
ܐܠܗܐ	Dio
ܐܣܛܘܢܝܐ	Estonia
ܛܝܣܬܐ	Aeroplano
ܩܪܒܐ	Guerra
1 (ܡܢܝܢܐ)	1 (numero)
2 (ܡܢܝܢܐ)	2 (numero)
3 (ܡܢܝܢܐ)	3 (numero)
4 (ܡܢܝܢܐ)	4 (numero)
5 (ܡܢܝܢܐ)	5 (numero)
ܠܐܛܒܝܐ	Lettonia
ܐܘܩܪܐܝܢܐ	Ucraina
ܬܫܝܟ	Repubblica Ceca
ܣܠܘܒܩܝܐ	Slovacchia
ܣܠܘܒܢܝܐ	Slovenia
ܡܘܠܕܘܒܐ	Moldavia
ܪܘܡܢܝܐ	Romania
ܒܘܠܓܐܪܝܐ	Bulgaria
ܪܗܘܡܐ (ܡܕܝܢܬܐ)	Roma
ܩܘܛܢܝܘܬܐ ܕܡܩܕܘܢܝܐ	Repubblica di Macedonia
ܐܠܒܢܝܐ	Albania
ܩܪܘܐܛܝܐ	Croazia
ܒܘܣܢܐ ܘܗܪܬܣܓܘܒܝܢܐ	Bosnia ed Erzegovina
ܐܙܪܒܝܓܐܢ	Azerbaigian
ܐܢܕܘܪܐ	Andorra
ܩܘܦܪܘܣ	Cipro
ܓܘܪܓܝܐ (ܐܬܪܐ)	Georgia
ܩܙܩܣܛܐܢ	Kazakistan
ܡܝܠܛܐ	Malta
ܡܘܢܐܩܘ	Principato di Monaco
ܛܘܪܐ ܐܘܟܡܐ	Montenegro
ܡܕܝܢܬܐ ܕܘܛܝܩܢ	Città del Vaticano
ܣܢ ܡܪܝܢܘ	San Marino
ܒܪܘܟܣܠ	Regione di Bruxelles-Capitale
ܠܘܕܒܝܓ ܒܐܢ ܒܝܛܗܘܒܢ	Ludwig van Beethoven
ܠܫܢܐ ܛܘܪܩܝܐ	Lingua turca
ܓܙܐܐܪ	Algeria
ܐܘܙܒܩܣܛܐܢ	Uzbekistan
ܘܐܪܣܘ	Varsavia
ܚܡܪܐ (ܫܬܝܐ)	Vino
ܡܝܐ	Acqua
ܦܪܣ ܚܙܘܐ	Televisione
ܬܫܝܠܝ	Cile
ܐܠ ܓܪܝܩܘ	El Greco
ܝܫܘܥ	Gesù
ܠܫܢܐ (ܡܡܠܠܐ)	Linguaggio
ܫܘܠܛܢ ܛܪܘܢܘܬܐ	Dittatura
ܡܡܠܠܘܬ ܟܘܟܒܐ	Astronomia
ܡܪܝܡ (ܐܡܗ ܕܝܫܘܥ)	Maria (madre di Gesù)
ܠܝܟܛܢܫܛܝܢ	Liechtenstein
ܐܕܘܠܦ ܗܝܛܠܪ	Adolf Hitler
ܠܝܢܘܟܣ	Linux
ܠܫܢܐ ܠܐܛܝܢܝܐ	Lingua latina
ܒܚܪܝܢ	Bahrein
ܐܪܡܢܝܐ	Armenia
ܣܪܒܝܐ	Serbia
ܣܗܪܐ	Luna
ܐܝܣܛܢܒܘܠ (ܡܕܝܢܬܐ)	Istanbul
ܐܘܣܛܪܠܝܐ (ܐܬܪܐ)	Australia
ܦܝܣܝܟ	Fisica
ܩܘܪܐܢ	Corano
ܐܣܠܐܡ	Islam
ܟܡܬܪܐ	Pyrus
ܠܟ ܒܐܘܢܣܐ	Lech Wałęsa
ܫܠܡܐ (ܫܝܢܐ)	Pace
ܚܘܝܕܐ ܐܘܪܘܦܝܐ	Unione europea
ܐܢܬܬܐ	Donna
ܛܝܙܐ	Ano
ܫܚܬܐ (ܝܘܠܦܢ ܨܪܘܝܘܬܐ)	Ascella
ܗܒܒܐ	Fiore
ܝܘܠܦܢ ܨܪܘܝܘܬܐ	Anatomia
ܡܕܝܢܬܐ	Città
ܢܐܦܠܝܘܢ ܒܘܢܐܦܪܛ	Napoleone Bonaparte
ܟܘܟܒܐ	Stella
ܫܡܫܐ	Sole
ܩܪܝܬܐ	Villaggio
ܝܡܐ ܕܡܕܢܚܐ	Mar Baltico
ܫܢܐ	Dente
ܘܝܩܝܡܝܕܝܐ ܩܘܡܡܘܢܣ	Wikimedia Commons
ܟܬܒܐ (ܣܦܪܐ)	Libro
ܝܘܡܐ	Giorno
ܠܠܝܐ	Notte
ܫܢܬܐ (ܙܒܢܐ)	Anno
ܕܪܐ	Secolo
ܐܘܣܠܘ	Oslo
ܠܫܒܘܢܐ	Lisbona
ܦܠܝܛܐ	Pianeta
ܙܡܪܘܬܐ	Musica
ܡܘܣܩܒܐ	Mosca (Russia)
ܠܫܢܐ ܐܝܛܠܝܐ	Lingua italiana
ܬܫܐܕ	Ciad
ܬܝܡܢܐ	Nord
ܢܝܘ ܙܝܠܢܕ	Nuova Zelanda
ܓܪܒܝܐ	Sud
ܗܢܕܘ	India
ܦܪܙܠܐ	Ferro
ܡܥܪܒܐ	Ovest
ܡܕܢܚܐ	Est
ܒܢܙܘܝܠܐ	Venezuela
ܛܠܦܣܢܐ	Scacchi
ܡܝܢ	Maine
ܣܘܣܝܐ	Equus caballus
ܐܡܣܛܪܕܐܡ	Amsterdam
ܙܝܢܐ	Arma
ܚܝܘܬܐ	Animalia
ܩܘܠܘܡܒܝܐ	Colombia
ܢܝܘ ܗܐܡܦܫܪ	New Hampshire
ܠܝܘܢܪܕܘ ܕܗ ܒܢܬܫܝ	Leonardo da Vinci
ܡܐܣܐܬܫܘܣܬܣ	Massachusetts
ܐܘܛܪܝܟܛ (ܗܘܦܪܟܝܐ)	Utrecht (provincia)
ܟܘܢܝܬܝܟܬ	Connecticut
ܐܝܪܐܢ	Iran
ܥܝܪܐܩ	Iraq
ܐܠܐܣܟܐ	Alaska
ܐܝܣܪܐܝܠ	Israele
ܐܘܛܪܝܟܛ (ܡܕܝܢܬܐ)	Utrecht
ܝܡܢ	Yemen
ܠܫܢܐ ܦܘܠܢܕܝܐ	Lingua polacca
ܝܘܪܕܢܢ	Giordania
ܩܝܪܓܝܙܣܛܐܢ	Kirghizistan
ܐܪܝܙܘܢܐ	Arizona
ܟܘܘܝܬ (ܐܬܪܐ)	Kuwait
ܠܒܢܢ	Libano
ܐܘܪܝܓܘܢ	Oregon
ܐܡܪܝܩܐ	America
ܝܘܬܐ	Utah
ܫܠܡܐ (ܦܬܓܡܐ)	Ciao
ܥܘܡܐܢ	Oman
ܦܐܩܣܛܐܢ	Pakistan
ܩܛܪ	Qatar
ܣܥܘܕܝܐ	Arabia Saudita
ܝܘܣܦ ܣܛܐܠܝܢ	Iosif Stalin
ܣܘܪܝܐ	Siria
ܛܐܓܝܩܣܛܐܢ	Tagikistan
ܦܪܣ ܩܠܐ	Radio (elettronica)
ܛܘܪܩܡܢܣܛܐܢ	Turkmenistan
ܐܡܝܪܘܬܐ ܥܪܒܝܬܐ ܡܚܝܕܬܐ	Emirati Arabi Uniti
ܐܦܓܐܢܣܛܐܢ	Afghanistan
ܕܗܒܐ	Oro
ܡܠܝ	Mali
ܦܝܠܝܦܝܢܝܐ	Filippine
ܩܘܛܢܝܘܬܐ ܕܐܦܪܝܩܐ ܡܨܥܝܬܐ	Repubblica Centrafricana
ܐܝܣܚܩ ܢܝܘܛܢ	Isaac Newton
ܫܥܘܬܐ (ܓܘܢܐ)	Giallo
ܬܘܢܣ (ܐܬܪܐ)	Tunisia
ܬܝܡܢܐ ܕܣܘܕܐܢ	Sudan del Sud
ܩܘܛܢܝܘܬܐ ܕܩܘܢܓܘ	Repubblica del Congo
ܩܘܛܢܝܘܬܐ ܕܩܘܢܓܘ ܕܝܡܘܩܪܛܝܬܐ	Repubblica Democratica del Congo
ܦܐܦܐ ܝܘܚܢܢ ܦܘܠܘܣ ܬܪܝܢܐ	Papa Giovanni Paolo II
ܛܒܝܠܝܣܝ	Tbilisi
ܩܐܡܪܘܢ	Camerun
ܠܘܒܐ	Libia
ܡܘܪܝܛܢܝܐ	Mauritania
ܡܓܪܒ	Marocco
ܢܝܓܪ	Niger
ܣܘܕܐܢ	Sudan
ܩܫܬܐ ܕܡܪܢ	Arcobaleno
ܗܐܡܒܘܪܓ	Amburgo
ܝܡܬܐ ܕܐܘܢܛܪܝܘ	Lago Ontario
ܝܡܬܐ ܕܣܘܦܝܪܝܘܪ	Lago Superiore
ܓܐܘܓܪܦܝܐ	Geografia
ܠܒܐ	Cuore umano
ܡܘܚܐ	Cervello
ܓܠܕܐ	Pelle
ܓܘܢܐ	Colore
ܦܪܐܓ	Praga
ܙܪܩܐ	Blu
ܟܣܦܐ (ܣܐܡܐ)	Argento
ܡܫܝܓܢ	Michigan
ܝܡܬܐ ܕܡܝܫܝܓܢ	Lago Michigan
ܐܠܝܢܘܝ	Illinois
ܢܘܪܬ ܕܐܟܘܬܐ	Dakota del Nord
ܣܐܘܬ ܕܐܟܘܬܐ	Dakota del Sud
ܡܘܢܬܐܢܐ	Montana
ܘܐܝܘܡܝܢܓ	Wyoming
ܐܘܪܫܠܡ	Gerusalemme
ܐܝܕܐܗܘ	Idaho
ܢܝܒܐܕܐ	Nevada
ܐܘܩܝܢܘܣ ܗܢܕܘܝܐ	Oceano Indiano
ܟܘܠܘܪܐܕܘ	Colorado
ܫܝܩܓܘ	Chicago
ܣܬܘܐ	Inverno
ܬܕܐܐ	Primavera
ܩܝܛܐ	Estate
ܬܫܪܝܬܐ	Autunno
ܨܕܐܡ ܚܘܣܝܢ	Saddam Hussein
ܠܫܢܐ ܐܣܦܢܝܐ	Lingua spagnola
ܓܘܓܝ	Araneae
ܐܒܐ (ܦܐܪܐ)	Frutto
ܒܪܓܝܢܝܐ	Virginia
ܝܡܬܐ ܕܝܘܪܘܢ	Lago Huron
ܢܝܘ ܝܘܪܩ (ܐܘܚܕܢܐ ܡܚܝܕܐ)	New York (Stato)
ܪܘܕ ܐܝܠܐܢܕ	Rhode Island
ܪܚܫܐ	Insecta
ܡܐܪܝܠܐܢܕ	Maryland
ܕܝܠܐܘܝܪ	Delaware
ܐܘܗܐܝܘ	Ohio
ܦܢܣܝܠܒܐܢܝܐ	Pennsylvania
ܐܝܛܙܢ	Uetersen
ܐܓܘܣܛܘܣ ܩܣܪ	Augusto
ܢܝܘ ܓܝܪܣܝ	New Jersey
ܐܢܕܝܐܢܐ	Indiana
ܪܕܝܬܐ	Autovettura
ܓܘܪܓܝܐ (ܐܘܚܕܢܐ ܡܚܝܕܐ)	Georgia (Stati Uniti d'America)
ܣܩܠܝܐ	Sicilia
ܣܢ (ܢܗܪܐ)	Senna
ܛܘܩܝܘ	Tokyo
ܦܪܕܝܢܢܕ ܡܓܝܠܢ	Ferdinando Magellano
ܢܝܘ ܡܝܟܣܝܟܘ	Nuovo Messico
ܐܬܢܘܣ	Atene
ܡܢܝܣܘܬܐ	Minnesota
ܒܓܕܐܕ (ܡܕܝܢܬܐ)	Baghdad
ܘܝܣܟܘܢܣܢ	Wisconsin
ܐܝܐܘܐ	Iowa
ܢܝܒܪܐܣܟܐ	Nebraska
ܟܐܢܣܐܣ	Kansas
ܡܝܙܘܪܝ	Missouri
ܐܪܟܢܣܐܣ	Arkansas
ܠܫܢܐ ܕܐܘܪܕܘ	Lingua urdu
ܐܘܟܠܐܗܘܡܐ	Oklahoma
ܝܡܐ ܕܓܪܒܝܐ	Mare del Nord
ܒܝܝܢܐ	Vienna
ܩܘܦܢܗܐܓܢ	Copenaghen
ܣܛܘܩܗܘܠܡ	Stoccolma
ܗܠܣܢܩܝ	Helsinki
ܕܒܠܢ	Dublino
ܒܪܛܝܣܠܐܒܐ	Bratislava
ܟܬܒܐ ܩܕܝܫܐ	Bibbia
ܥܕܬܐ ܫܪܝܪܬܐ ܕܝܫܘܥ	Vera Chiesa di Gesù
ܠܫܢܐ ܐܢܓܠܝܐ	Lingua inglese
ܩܘܢܣܦܣܝܘܢ (ܬܫܝܠܝ)	Concepción (Cile)
ܐܘܢܛܐܪܝܘ	Ontario
ܡܐܢܝܛܘܒܐ	Manitoba
ܐܠܒܪܛܐ	Alberta
ܢܘܒܐ ܣܩܘܛܝܐ	Nuova Scozia
ܩܘܢܣܩܘܒܘܠܐ	Końskowola
ܢܝܘ ܒܪܘܢܙܘܝܩ	Nuovo Brunswick
ܩܘܠܘܡܒܝܐ ܒܪܝܛܝܬܐ	Columbia Britannica
ܓܙܪܬܐ ܕܐܡܝܪܐ ܐܕܘܐܪܕ	Isola del Principe Edoardo
ܣܐܣܩܐܬܫܘܐܢ	Saskatchewan
2012	2012
2011	2011
2010	2010
2009	2009
ܢܝܘܦܐܘܢܕܠܢܕ ܘܠܐܒܪܐܕܘܪ	Terranova e Labrador
2008	2008
ܐܘܚܕܢܐ ܓܪܒܝܝܐ-ܡܥܪܒܝܐ	Territori del Nord-Ovest
ܝܘܩܘܢ	Yukon
2005	2005
2006	2006
ܢܘܢܐܒܘܛ	Nunavut
2007	2007
ܡܐܟܘܠܬܐ	Alimento
ܚܘܝܐ	Serpentes
ܩܘܪܘܦ	Kurów
ܟܝܡܝܐ	Chimica
1968	1968
ܩܛܠܥܡܐ ܝܗܘܕܝܐ	Olocausto
ܡܕܪܝܕ (ܡܕܝܢܬܐ)	Madrid
ܗܘܦܪܟܝܣ ܘܐܘܚܕܢܐ ܕܩܢܕܐ	Province e territori del Canada
ܣܢܛܝܐܓܘ ܕܐ ܬܫܝܠܝ	Santiago del Cile
ܚܐܪܘܬܐ	Libertà
ܣܝܕܢܝ	Sydney
ܝܪܘܩܐ	Verde
ܡܠܒܘܪܢ	Melbourne
ܣܘܡܩܐ	Rosso
ܢܘܪܐ (ܕܠܩܐ)	Fuoco
ܢܝܠܘܣ	Nilo
ܓܙܐܐܪ (ܡܕܝܢܬܐ)	Algeri
ܬܘܢܣ (ܡܕܝܢܬܐ)	Tunisi
ܛܗܪܐܢ	Teheran
ܐܢܩܪܐ	Ankara
ܢܝܐܡܝ	Niamey
ܒܡܩܘ	Bamako
ܕܪܡܣܘܩ	Damasco
ܥܡܐܢ	Amman
ܒܝܪܘܬ	Beirut
ܒܝܬ ܨܘܒܐ	Università
ܒܝܬܐ (ܒܢܝܢܐ)	Casa
ܐܘܣܛܪܠܝܐ (ܝܒܫܬܐ)	Australia (continente)
ܢܗܪܐ	Fiume
ܪܝܫܐ ܕܣܒܪܐ ܛܒܐ	Capo di Buona Speranza
ܫܘܚܡܠܐ	Investimento
ܩܘܪܝܛܝܒܐ	Curitiba
ܥܒܐ	Foresta
ܩܘܢܦܘܫܝܘܣ	Confucio
ܩܢܐ	Nido
ܐܘܪܘ	Euro
ܝܡܐ ܚܘܪܐ ܡܨܥܝܐ	Mar Mediterraneo
ܓܘܪܓܝܐ	Georgia (disambigua)
ܡܫܝܚܝܘܬܐ	Cristianesimo
ܩܠܒܐ:ܐܘܝܐ	Template:Favorevole
ܝܒܫܬܐ	Continente
ܛܝܪܐ	Aves
ܐܪܫܟܝܬܐ	Capitale (città)
ܠܫܢܐ ܦܘܪܛܘܓܠܝܐ	Lingua portoghese
ܝܪܚܐ	Mese
ܡܘܨܛܦܐ ܟܡܐܠ ܐܛܐܛܘܪܩ	Mustafa Kemal Atatürk
ܐܠܡܐܙܢ	Almazán
ܠܫܢܐ ܝܦܢܝܐ	Lingua giapponese
ܦܐܬܐ ܪܝܫܝܬܐ	Pagina principale
ܦܪܢܣܝܣܩܘ ܓܘܝܐ	Francisco Goya
ܝܡܐ ܐܚܪܝܐ	Mar Caspio
ܝܡܬܐ ܕܐܝܪܝ	Lago Erie
ܣܠܒܐܕܘܪ ܕܐܠܝ	Salvador Dalí
ܒܢܣܢܬ ܦܢ ܟܘܟ	Vincent van Gogh
ܦܪܝܕܐ ܩܐܠܘ	Frida Kahlo
ܗܢܪܝ ܡܐܛܝܣ	Henri Matisse
ܡܝܟܠܐܢܓܠܘ	Michelangelo Buonarroti
ܦܒܠܘ ܦܝܩܐܣܘ	Pablo Picasso
ܪܡܒܪܢܛ	Rembrandt
ܐܢܕܝ ܘܘܪܗܘܠ	Andy Warhol
ܢܝܢܘܐ (ܡܕܝܢܬܐ)	Ninive
ܒܒܠ	Babilonia
ܐܝܪܝܚܘ	Gerico
ܩܛܠܘܢܝܐ	Catalogna
ܡܕܪܝܕ (ܗܘܦܪܟܝܐ)	Madrid (comunità autonoma)
ܒܝܬ ܠܚܡ	Betlemme
ܣܕܪܐ:Candidates for speedy deletion	Categoria:Cancellare subito
ܪܫܡܠܘܬܐ	Capitalismo
ܐܘܡܬܐ	Nazione
ܩܪܬܐܓܘ	Cartagine
ܣܕܪܐ:ܐܣܛܪܘܢܘܡܝܐ	Categoria:Astronomia
ܨܚܪܐܐ	Deserto del Sahara
ܫܐܕܐ	Diavolo
ܒܝܬ ܟܬܒܐ	Biblioteca
ܫܘܠܛܢܘܬܐ (ܫܘܬܐܣܐ)	Governo
ܬܫܝܢ ܫܝ ܗܘܐܢܓ	Qin Shi Huang
ܡܕܢܚܐ ܡܨܥܝܬܐ	Medio Oriente
ܡܠܟܘܬܐ	Monarchia
ܩܘܛܢܝܘܬܐ	Repubblica
ܐܬܪܐ	Stato
ܓܒܐ	Partito politico
ܝܗܘܕܝܐ	Ebrei
ܝܡܡܬܐ ܪܘܪܒܬܐ	Grandi Laghi (America)
ܐܘܩܝܢܘܣ ܬܝܡܢܝܐ	Oceano antartico
ܐܕܢܐ (ܝܘܠܦܢ ܨܪܘܝܘܬܐ)	Orecchio
ܢܚܝܪܐ	Naso
ܥܝܢܐ (ܝܘܠܦܢ ܨܪܘܝܘܬܐ)	Occhio
ܥܘܩܒܪܬܐ	Muscolo
ܙܡܝܪܬܐ	Canzone
ܓܡܠܐ	Camelus
ܫܘܫܡܢܐ	Formicidae
ܕܒܫܬܐ	Anthophila
ܠܫܢܐ ܗܘܠܢܕܝܐ	Lingua olandese
ܐܡܐ (ܒܝܬܝܘܬܐ)	Madre
ܐܒܐ (ܒܝܬܝܘܬܐ)	Padre
1847	1847
ܨܦܪܐ (ܙܒܢܐ)	Mattino
ܪܡܫܐ	Sera
ܩܛܝܢܬܐ	Minuto
ܠܫܢܐ ܪܘܣܝܐ	Lingua russa
ܩܢܘܢܐ	Diritto
ܠܫܢܐ ܨܝܢܝܐ	Lingua cinese
ܕܡܐ	Sangue
ܬܓܪܘܡܬܐ	Scheletro (anatomia)
ܪܐܬܐ	Polmone
ܠܫܢܐ ܪܘܡܢܝܐ	Lingua romena
ܡܛܪܐ	Pioggia
ܢܠܣܘܢ ܡܐܢܕܝܠܐ	Nelson Mandela
ܐܒܢܐ	Roccia
ܥܢܢܐ	Nuvola
ܩܢܘܢܐ ܕܠܥܙܐ	Grammatica
ܠܫܢܐ ܓܘܪܓܝܐ	Lingua georgiana
ܝܘܠܦܢ ܡܡܫܚܘܬܐ	Economia
ܙܘܙܐ	Valuta
ܡܕܐܬܐ	Imposta
ܐܠܦܒܝܬ ܥܪܒܝܐ	Alfabeto arabo
ܐܠܦܒܝܬ ܝܘܢܝܐ	Alfabeto greco
ܐܠܦܒܝܬ ܠܐܛܝܢܝܐ	Alfabeto latino
ܣܕܪܐ:ܦܪܢܣܐ	Categoria:Francia
ܟܢܫܐ	Società (sociologia)
ܓܒܪܐ	Uomo (genere)
ܙܘܘܓܐ	Matrimonio
ܙܕܩܐ ܕܒܪܢܫܐ	Diritti umani
ܩܪܒܐ ܓܘܝܐ	Guerra civile
ܓܪܡܐ ܕܣܢܘܢܝܬܐ	Sterno
ܬܪܝܢܐ	Succo di frutta
ܚܠܒܐ (ܕܝܘܒܐ)	Latte
ܛܘܪܐ	Montagna
ܡܕܒܪܐ	Deserto
ܠܫܢܐ ܐܠܒܢܝܐ	Lingua albanese
ܠܫܢܐ ܐܪܡܢܝܐ	Lingua armena
ܝܘܗܐܢ ܓܘܛܢܒܪܓ	Johannes Gutenberg
ܠܫܢܐ ܣܘܝܕܝܐ	Lingua svedese
ܢܝܩܘܠܐ ܛܣܠܐ	Nikola Tesla
ܡܘܫܐ	Mosè
ܬܕܐ	Mammella
ܢܘܗܪܐ (ܚܙܝܬܐ)	Luce
ܠܫܢܐ ܝܘܢܝܐ	Lingua greca
ܠܫܢܐ ܦܪܣܝܐ	Lingua persiana
ܬܘܕܝܬܐ	Religione
ܐܒܪܗܡ	Abramo
ܣܦܪܐ ܕܒܪܝܬܐ	Genesi
ܠܫܢܐ ܩܢܛܘܢܝܐ	Lingua cantonese
ܠܫܢܐ ܡܢܕܪܝܢܝܐ	Lingua cinese mandarino
ܦܘܠܘܣ ܫܠܝܚܐ	Paolo di Tarso
ܙܝܓܡܘܢܕ ܦܪܘܝܕ	Sigmund Freud
ܙܠܛܐ	Insalata
ܝܗܘܕܝܘܬܐ	Ebraismo
ܠܫܢܐ ܥܒܪܝܐ	Lingua ebraica
ܟܒܕܐ	Fegato
ܛܚܠܐ	Milza
ܟܘܠܝܬܐ	Rene
ܫܠܦܘܚܬܐ	Vescica urinaria
ܐܫܟܐ	Testicolo
ܐܘܩܝܢܘܣ	Oceano
ܒܘܕܗܐ	Gautama Buddha
ܡܘܚܡܕ	Maometto
ܟܪܣܐ	Addome
ܚܒܠܐ ܟܘܒܝܐ	Midollo spinale
ܘܪܝܕܐ	Vena
ܡܪܒܥܐ	Utero
ܠܫܢܐ (ܗܕܡܐ)	Lingua (anatomia)
ܓܝܕܐ	Nervo
ܨܘܪܐ (ܝܘܠܦܢ ܨܪܘܝܘܬܐ)	Collo
ܦܘܡܐ	Bocca
ܓܓܪܬܐ	Laringe
ܡܥܝܐ	Intestino
ܫܪܝܬܐ	Articolazione
ܬܝܪܬܐ	Ghiandola
ܚܠܒܐ (ܝܘܠܦܢ ܨܪܘܝܘܬܐ)	Muscolo diaframma
ܫܪܝܢܐ	Arteria
A	A
B	B
ܢܘܛܦܬܐ	Sperma
G	G
U	U
Z	Z
F	F
J	J
ܐܠܦܒܝܬ	Alfabeto
T	T
C	C
R	R
D	D
Α	Alfa (lettera)
Ω	Omega (lettera)
I	I
Μ	Mi (lettera)
E	E
H	H
ܗܐܪܠܡ (ܗܘܠܢܕܐ)	Haarlem
K	K
L	L
M	M
N	N
O	O
Q	Q
S	S
V	V
W	W
X	X
Y	Y
ܐܢܫܟܕܐ	Enschede
ܗܢܓܠܘ	Hengelo (Overijssel)
Φ	Phi (lettera)
ܝܘܢܐ	Columbidae
ܐܝܠܢܐ	Albero
Λ	Lambda
ܓܒܬܐ	Formaggio
ܥܢܒܬܐ	Uva
ܕܒܫܐ	Miele
ܒܣܪܐ	Carne
ܣܦܪܙܒܢܐ	Giornale
ܙܥܘܩܐ	Telefono
ܡܪܕܘܬܐ	Cultura
ܡܥܝܐ ܥܒܝܐ	Intestino crasso
ܡܥܝܐ ܩܛܝܢܐ	Intestino tenue
ܣܘܪܓܕܐ ܝܘܠܝܝܐ	Calendario giuliano
ܐܣܝܘܬܐ	Medicina
ܣܕܪܐ:ܒܪܐܙܝܠ	Categoria:Brasile
ܙܘܝܬܐ (ܡܚܪܘܬܐ)	Angolo
ܬܘܩܦܐ	Energia
ܣܦܝܢܬܐ	Nave
ܩܠܐ (ܨܘܬܐ)	Suono
ܙܓܘܓܝܬܐ	Vetro
ܫܛܝܚܘܬܐ	Area
ܡܢܝܢܐ	Numero
ܪܦܦܐ	Secondo
ܣܥܪܬܐ	Hordeum vulgare
ܘܘܗܐܢ	Wuhan
ܡܟܬܒܢܘܬܐ ܕܐܬܪܘܬܐ	Stati del mondo
ܒܝܬ ܢܗܪܝܢ	Mesopotamia
ܕܒܐ	Ursidae
ܡܠܟܐ	Re
ܚܛܬܐ	Triticum
ܣܘܪܓܕܐ	Calendario
ܟܘܪܗܢܐ	Malattia
ܣܘܪܓܕܐ ܓܪܝܓܘܪܝܐ	Calendario gregoriano
ܟܦܣܐ	Mestruazione
ܥܡܐ ܩܪܕܘܝܐ	Curdi
ܓܫܪܐ	Ponte
ܡܓܕܠܐ (ܒܢܝܢܐ)	Torre
ܐܡܪܝܩܐ ܠܐܛܝܢܝܬܐ	America Latina
ܟܗܪܒܐ	Elettricità
ܡܙܝܥܢܐ ܕܩܝܕܐ ܓܘܝܐ	Motore a combustione interna
ܣܝܦܐ (ܙܝܢܐ)	Spada
ܫܡܥܘܢ ܩܢܢܝܐ	Simone il Cananeo
ܩܪܩܦܬܐ	Cranio
ܓܘܡܠܐ!	Joomla!
ܐܦܫܬܐ	Uva passa
ܠܫܢܐ ܕܗܣܝܐܢܓ	Lingua xiang
ܠܫܢܐ ܥܪܒܝܐ	Lingua araba
ܠܫܢܐ ܐܦܪܝܩܐܢܝܐ	Lingua afrikaans
Β	Beta (lettera)
Γ	Gamma (lettera)
Δ	Delta (lettera)
Ε	Epsilon (lettera)
Ζ	Zeta (lettera greca)
Η	Eta (lettera)
Θ	Theta
Ι	Iota
Κ	Kappa (lettera greca)
Ν	Ni (lettera)
Ξ	Xi (lettera)
Ο	Omicron
Ρ	Rho (lettera)
Σ	Sigma (lettera greca)
Τ	Tau (lettera)
Υ	Ypsilon
Χ	Chi (lettera)
Ψ	Psi (lettera)
ܐܬܐ	Bandiera
ܟܪܦܬܐ	Arredamento
ܟܘܪܣܝܐ	Sedia
ܣܦܬܐ	Labbro
ܦܣܡܐ	Baffo (peli del viso)
ܥܩܠܐ	Piede
1000000000 (ܡܢܝܢܐ)	Miliardo
ܓܪܡܐ ܕܨܕܥܐ	Osso temporale
ܩܠܝܕܐ (ܓܪܡܐ)	Clavicola
ܟܬܦܐ	Spalla
ܦܟܐ ܬܚܬܝܐ	Mandibola
ܩܠܒܐ:Link FA	Template:Link V
ܥܠܡܐ (ܐܪܥܐ)	Mondo
ܘܝܩܝܦܕܝܐ:ܬܪܥܐ ܕܟܢܫܐ	Wikipedia:Bar
ܒܝܪܡܘܢܬ	Vermont
ܩܘܣܛܢܛܝܢܘܦܘܠܝܣ	Costantinopoli
ܒܝܬ ܟܪܝܗܐ	Ospedale
ܥܕܬܐ	Chiesa (architettura)
ܕܝܬܝܩܝ ܚܕܬܐ	Nuovo Testamento
9 (ܡܢܝܢܐ)	9 (numero)
1002	1002
ܦܘܕܘܠܣܟ	Podol'sk
ܦܐܦܐ	Papa
5	5
4	4
ܢܝܒܐ	Canino (anatomia)
3	3
2	2
ܒܝܬ ܥܬܩܐ ܕܠܘܒܪ	Museo del Louvre
ܓܒܐ ܕܚܐܪܘܬܐ ܕܦܘܐܪܛܘ ܪܝܩܘ	Partito Indipendentista Portoricano
6	6
ܕܝܬܝܩܝ ܥܬܝܩܬܐ	Antico Testamento
ܥܐܕܐ ܕܒܝܬ ܝܠܕܐ	Natale
ܠܫܢܐ ܪܘܡܐܢܣܝܐ	Lingue romanze
ܡܬܠܬܐ	Triangolo
ܫܢܬܐ ܟܒܝܫܬܐ	Anno bisestile
ܡܘܥܡܪ ܐܠܩܕܐܦܝ	Mu'ammar Gheddafi
ب	Bāʼ
ܥܐܕܐ ܕܩܝܡܬܐ	Pasqua
ܢܝܘ ܝܘܪܩ	New York (disambigua)
ܢܦܛܐ	Petrolio
ܣܐܘܢܐ	Scarpa
ܒܝܬ ܥܘܪܦܢܐ	Banca
ܟܪܡܐ	Vigneto
ܐܝܪܠܢܕ (ܓܙܪܬܐ)	Irlanda (isola)
1	1
ܠܘ ܫܘܢ	Lu Xun
10	10
20	20
9	9
7	7
8	8
7 (ܡܢܝܢܐ)	7 (numero)
8 (ܡܢܝܢܐ)	8 (numero)
12	12
ܡܠܐܐ ܘܬܘܒܐ	Marea
ܫܒܘܥܐ	Settimana
ܓܠܝܕܐ	Ghiaccio
ܨܠܘܬܐ ܡܪܢܝܬܐ	Padre nostro
ܝܡܬܐ	Lago
ܝܡܐ ܣܘܡܩܐ	Mar Rosso
13	13
ܩܛܘܬܐ (ܝܥܝܬܐ)	Cucumis sativus
ܓܙܪܬܐ	Isola
ܚܘܪܐ	Bianco
ܐܘܟܡܐ	Nero
6 (ܡܢܝܢܐ)	6 (numero)
ܠܫܢܐ ܪܘܫܡܝܐ	Lingua ufficiale
11	11
15	15
14	14
17	17
ܣܦܪ ܡܠܐ	Dizionario
18	18
19	19
16	16
21	21
ܦܠܣܛܝܢ	Palestina
10 (ܡܢܝܢܐ)	10 (numero)
ܡܣܘܪܩܐ (ܡܐܢܐ)	Pettine
ܠܝܠܐ ܕܘܢܤ	Lila Downs
ܝܡܐ ܕܡܠܚܐ	Mar Morto
ܫܘܚܠܦܐ ܕܫܢܬܐ	Stagione
ܠܝܒܪܦܘܠ	Liverpool
ܩܘܦܬܐ (ܛܝܪܐ)	Strigiformes
ܫܥܬܐ	Ora
ܢܐܘܝ ܕܘܪ ܟܪܘܠܣܟܝ	Nowy Dwór Królewski
ܐܪܙܦܬܐ	Martello
ܝܘܢܫܘܦܝܢ	Jönköping
ܥܘܠܐ ܚܝܐ	Feto
ܐܠܦܒܝܬ ܣܘܪܝܝܐ	Alfabeto siriaco
ܐܠܦܒܝܬ ܐܪܡܝܐ	Alfabeto aramaico
ܐܣܝܐ ܡܥܪܒܝܬܐ	Asia occidentale
ܙܡܪܐ	Canto (musica)
ܫܓܠܐ	Campana (gioco)
ܡܙܬܐ	Pelo
ܠܫܢܐ ܐܪܡܝܐ	Lingua aramaica
ܨܦܪܐ (ܛܝܪܐ)	Passeridae
ܐܦܣܩܘܦܐ	Vescovo
ܓܒܐ ܕܝܡܘܩܪܛܝܐ (ܐܘܚܕܢܐ ܡܚܝܕܐ)	Partito Democratico (Stati Uniti d'America)
ܒܝܐܛܪܝܟܣ ܕܒܝܬ ܗܘܠܢܕܝܐ	Beatrice dei Paesi Bassi
ܡܠܟܘܬܐ ܕܗܘܠܢܕܐ	Regno dei Paesi Bassi
ܐܒܪܝܠ ܠܐܒܝܢ	Avril Lavigne
ܪܝܫ ܩܘܛܢܝܘܬܐ	Presidente
ܐܪܒܝܐ	Penisola araba
ܡܪܩܘܣ ܐܘܢܓܠܣܛܐ	Marco evangelista
ܥܘܠܐ	Embrione
ܠܫܢܐ ܕܗܟܐ	Lingua hakka
ܫܘܫܡܢܝܬܐ (ܝܥܝܬܐ)	Cardamomo
ܠܫܢܐ ܕܓܐܢ	Lingua gan
ܒܝܬ ܥܬܩܐ	Museo
ܐܠܦܒܝܬ ܥܒܪܝܐ	Alfabeto ebraico
ܠܫܢܐ ܣܘܪܝܝܐ	Lingua siriaca
ܒܪܩܐ	Fulmine
ܐܝܕܐ	Mano
ܫܡܥܘܢ ܟܐܦܐ	Pietro apostolo
ܬܠ ܐܒܝܒ	Tel Aviv
ܒܐܠܦܐܪܐܝܣܘ	Valparaíso
ܠܫܢܐ ܫܝܡܝܐ	Lingue semitiche
ܚܘܣܢܝ ܡܘܒܐܪܟ	Hosni Mubarak
ܘܐܟܐܩܐ	Oaxaca (stato)
ܚܐܘܬܐ	Burro
ܐܘܢܓܠܝܘܢ	Vangelo
ܠܫܢܐ ܕܘܘ	Lingua wu
ܪܘܛܪܕܐܡ	Rotterdam
ܩܪܛܐ	Creta
ܐܘܪܚܐ	Strada
ܩܘܪܨܐ ܚܠܝܨܐ	Compact disc
ܨܒܥܐ	Dito
ܦܪܬ	Eufrate
ܩܝܘܛܘ	Kyoto
ܥܣܪܐ ܦܘܩܕܢܐ	Dieci comandamenti
ܒܪܩܩܐ ܦܪܣܝܐ	Golfo Persico
ܚܠܐ (ܕܚܝܚܐ)	Sabbia
ܘܪܕܐ	Rosa (botanica)
ܓܙܪܬܐ ܝܒܫܢܝܬܐ	Penisola
ܐܘܪܝܬܐ	Torah
ܟܘܘܝܬ (ܡܕܝܢܬܐ)	Madinat al-Kuwait
ܡܚܙܝܬܐ	Specchio
ܥܡܐ ܥܪܒܝܐ	Arabi
ܟܘܬܐ	Finestra
ܠܫܢܐ ܝܘܢܝܐ ܥܬܝܩܐ	Lingua greca antica
ܠܫܢܐ ܐܟܕܝܐ	Lingua accadica
ܕܩܠܬ	Tigri
ܐܬܪܘܬܐ ܕܐܬܪܘܬܐ ܡܚܝܕܐ ܕܐܡܪܝܩܐ	Stato federato degli Stati Uniti d'America
ܡܥܡܘܕܝܬܐ	Battesimo
ܩܘܢܓܘ	Congo
ܐܝܢܛܪܠܝܢܓܘܐ	Interlingua (lingua ausiliaria)
ܐܘܪܟܐ	Lunghezza
ܚܠܡܐ	Sogno
ܠܫܢܐ ܩܪܕܘܝܐ	Lingua curda
ܩܡܚܐ	Farina
ܕܢ ܗܐܟ	L'Aia
ܠܫܢܐ ܦܘܢܝܩܝܐ	Lingua fenicia
ܣܝܢܝ (ܓܙܪܬܐ ܝܒܫܢܝܬܐ)	Penisola del Sinai
ܟܪܘܙܘܬܐ ܕܝܘܚܢܢ	Vangelo secondo Giovanni
ܬܪܥܐ (ܒܒܐ)	Porta
ܪܝܗܐܢܐ	Rihanna
ܛܦܪܐ	Unghia
ܐܦܐ	Viso
ܨܨܐ (ܨܢܥܬܐ)	Chiodo
ܙܝܬܐ	Olea europaea
ܬܠܝܬܝܘܬܐ	Trinità (cristianesimo)
ܓܠܠܐ	Onda
ܟܬܒܬܐ	Scrittura
ܪܘܚܐ ܕܩܘܕܫܐ	Spirito Santo
100 (ܡܢܝܢܐ)	100 (numero)
ܒܘܪܟܐ	Ginocchio
ܫܘܩܐ (ܬܐܓܪܘܬܐ)	Mercato
ܠܫܢܐ ܥܪܒܝܐ ܝܗܘܕܝܐ	Lingue giudeo-arabe
ܒܠܛܝ	Bălți
1000000 (ܡܢܝܢܐ)	Milione
ܛܐܒܐ	Notizia
ܐܫܬܐ (ܐܣܝܘܬܐ)	Febbre
ܩܫܬܐ ܓܪܒܝܝܬܐ ܕܐܪܥܐ	Emisfero boreale
ܡܡܘܢܐ ܕܡܝܟܪܐ	Microeconomia
ܠܝܕܣ	Leeds
ܥܘܩܒܪܐ	Mus (genere)
ܦܘܪܬܩܠܐ	Arancione
ܒܪܩܩܐ	Baia
ܒܝܬ ܩܒܘܪܐ	Cimitero
ܐܣܝܐ (ܫܕܬܐ)	Medico
ܡܩܕܘܢܝܐ	Macedonia
ܦܢܛܝܩܘܣܛܝ	Pentecoste
ܫܓܕܬܐ	Prunus dulcis
ܟܪܘܙܘܬܐ ܕܠܘܩܐ	Vangelo secondo Luca
ܩܘܢܣܦܣܝܘܢ (ܗܘܦܪܟܝܐ)	Provincia di Concepción (Cile)
ܢܗܪܐ ܕܝܘܪܕܢܢ	Giordano (fiume)
ܣܦܪ ܝܡܐ	Spiaggia
ܐܢܛܐܠܝܐ (ܗܘܦܪܟܝܐ)	Provincia di Adalia
ܦܪܟܣܝܣ ܕܫܠܝܚܐ	Atti degli Apostoli
ܥܪܘܒܬܐ ܕܚܫܐ	Venerdì santo
ܚܒܘܫܝܐ	Prigione
ܐܕܢܐ (ܗܘܦܪܟܝܐ)	Provincia di Adana
ܝܘܚܢܢ ܡܥܡܕܢܐ	Giovanni Battista
ܨܠܝܒܐ	Croce
ܚܙܒܐܠܠܗ	Hezbollah
ܒܝܬ ܓܒܝܢܐ	Fronte (anatomia)
ܡܙܡܘܪܐ	Salmi
ܐܬܘܪ	Assiria
ܒܢܝܢܐ	Edificio
ܚܠܒ (ܡܕܝܢܬܐ)	Aleppo
ܩܫܬܐ ܬܝܡܢܝܬܐ ܕܐܪܥܐ	Emisfero australe
ܚܠܐ (ܚܡܪܐ)	Aceto
ܒܝܬ ܕܝܢܐ	Tribunale
ܚܝܦܐ	Haifa
ܫܛܪܐ ܬܐܒܝܠܝܐ ܕܓܝܢܝܣ	Guinness dei primati
ܟܘܕܢܝܐ	Mulo
ܒܪܩܩܐ ܕܥܕܢ	Golfo di Aden
ܓܠܝܢܐ ܕܝܘܚܢܢ	Apocalisse di Giovanni
ܐܫܬܐ (ܝܘܠܦܢ ܨܪܘܝܘܬܐ)	Natiche
ܨܠܘܬܐ ܡܪܝܡܝܬܐ	Ave Maria
ܝܩܕܐ	Combustibile
ܝܨܝܠܐ	Gomito
ܟܗܢܐ	Sacerdote
ܕܩܢܐ	Barba
ܢܒܝܐ	Profeta
ܐܘܪܟܝܣܛܪܐ	Orchestra
1000 (ܡܢܝܢܐ)	1000 (numero)
ܣܘܦܝܐ ܪܘܛܐܪܘ	Sofija Rotaru
ܬܫܢܝܬܐ	Assicurazione
ܛܘܟܣܐ	Organizzazione
ܣܦܪܓܠܐ	Cydonia oblonga
ܐܢܕܪܐܘܣ ܫܠܝܚܐ	Andrea apostolo
ܬܪܥܣܪ ܫܠܝܚܐ	Apostolo
ܢܩܒܬܐ	Femmina (biologia)
ܕܪܥܐ (ܗܕܡܐ)	Braccio
ܡܬܝ ܡܟܣܐ	Matteo apostolo ed evangelista
ܬܐܘܡܐ ܫܠܝܚܐ	Tommaso apostolo
ܦܝܠܝܦܘܣ ܫܠܝܚܐ	Filippo apostolo
ܒܘܪܨܐ (ܗܘܦܪܟܝܐ)	Provincia di Bursa
ܐܝܘܐܢܢܝܣ ܦܘܡܐ ܕܕܗܒܐ	Giovanni Crisostomo
ܒܢܝܡܝܢ ܢܬܢܝܗܘ	Benjamin Netanyahu
ܐܪܬܒܝܢ (ܗܘܦܪܟܝܐ)	Provincia di Artvin
ܓܒܝܢܐ	Sopracciglio
ܫܘܪܬܐ	Ombelico
ܐܕܝܐܡܐܢ (ܗܘܦܪܟܝܐ)	Provincia di Adıyaman
ܝܗܘܕܐ ܫܠܝܚܐ	Giuda Taddeo
ܒܪܬܘܠܡܝ ܫܠܝܚܐ	Bartolomeo apostolo
ܝܥܩܘܒ ܒܪ ܙܒܕܝ	Giacomo il Maggiore
ܡܬܝܐ ܫܠܝܚܐ	Mattia apostolo
ܝܥܩܘܒ ܒܪ ܚܠܦܝ	Giacomo il Minore
ܕܟܪܐ	Maschio (biologia)
ܐܝܓܢܐܛܝܘܣ ܢܘܪܢܐ	Ignazio di Antiochia
ܪܕܝܘܗܕ	Radiohead
ܒܫܐܪ ܐܠܐܣܕ	Bashar al-Assad
ܪܚܝܐ	Mulino
ܨܘܡܐ	Digiuno
ܕܝܪܐ	Monastero
ܡܠܚܐ (ܢܘܛܐ)	Marinaio
ܐܦܝܘܢ (ܗܘܦܪܟܝܐ)	Provincia di Afyonkarahisar
ܡܝܟܐܝܠ (ܡܠܐܟܐ)	Arcangelo Michele
ܒܝܠܓܝܟ (ܗܘܦܪܟܝܐ)	Provincia di Bilecik
ܒܝܬ ܥܬܩܐ ܕܐܣܪܐܝܠ	Israel Museum
ܒܐܠܝܟܣܝܪ (ܗܘܦܪܟܝܐ)	Provincia di Balıkesir
ܒܝܬ ܝܠܕܐ	Compleanno
ܬܘܠܥܐ	Verme
ܬܘܩܢ ܓܝܕܝܐ ܩܢܛܪܘܢܝܐ	Sistema nervoso centrale
ܛܘܪܐ ܕܓܠܝܕܐ	Iceberg
ܡܫܠܡܢܐ	Musulmano
ܢܢܥܐ	Mentha
ܩܠܒܐ:Commonscat	Template:Commonscat
ܒܨܪܐ (ܡܕܝܢܬܐ)	Bassora
ܐܓܪܬܐ ܕܠܘܬ ܪܗܘܡܝܐ	Lettera ai Romani
ܬܡܪܐ ܕܥܝܢܐ	Palpebra
ܗܘܦܪܟܝܣ ܕܛܘܪܩܝܐ	Province della Turchia
ܡܪܝ ܓܝܘܪܓܝܣ ܣܗܕܐ	San Giorgio
ܐܣܘܬܐ ܕܠܐ ܬܚܘܡܐ	Medici senza frontiere
ܐܪܙܐ (ܡܫܝܚܝܘܬܐ)	Sacramento
ܐܓܪܬܐ ܕܠܘܬ ܦܝܠܝܦܣܝܐ	Lettera ai Filippesi
ܐܢܛܘܠܝܐ	Anatolia
ܡܫܝܚܐ	Messia
ܚܫܡܝܬܐ ܐܚܪܝܬܐ	Ultima Cena
ܩܢܘܢܐ ܕܗܝܡܢܘܬܐ	Simbolo degli apostoli
ܒܢܝ ܐܝܣܪܐܝܠ	Dodici tribù di Israele
ܡܓܘܫܐ ܬܠܬܐ	Magi (Bibbia)
ܝܘܚܢܢ ܕܪܡܣܘܩܝܐ	Giovanni Damasceno
ܒܒܐ (ܬܪܥܐ)	Cancello
ܣܕܪܐ:ܪܘܟܒ ܫܘܠܛܢܘܬܐ	Categoria:Forme di governo
ܠܫܢܐ ܕܡܝܢ	Lingua min
ܥܘܪܡܫܐ	Inquinamento
ܒܒܠ (ܗܘܦܪܟܝܐ)	Governatorato di Babil
ܫܘܡܪܐ	Particolato carbonioso
ܐܫܩܠܘܢ	Ascalona
ܕܘܢܒܐ	Coda (anatomia)
ܩܐܕܣܝܐ (ܗܘܦܪܟܝܐ)	Governatorato di al-Qadisiyya
ܡܪܝܡ ܡܓܕܠܝܬܐ	Maria Maddalena
ܡܪܪܬܐ	Cistifellea
ܥܕܬܐ ܟܠܕܝܬܐ ܩܬܘܠܝܩܝܬܐ	Chiesa cattolica caldea
ܥܕܬܐ ܡܪܘܢܝܬܐ	Chiesa maronita
ܡܪܬܐ	Bile
ܩܘܪܒܢܐ	Eucaristia
ܐܕܡ	Adamo
ܐܘܘܫܐ	Cerume
ܕܡܥܬܐ	Lacrima
ܥܡܐ (ܒܝܬܝܘܬܐ)	Zio
ܝܘܗܐܢ ܐܠܙܪ	Georg Elser
ܒܝܢܓܘܠ (ܗܘܦܪܟܝܐ)	Provincia di Bingöl
ܥܡܐ ܐܪܡܢܝܐ	Armeni
ܐܝܕܝܢ (ܗܘܦܪܟܝܐ)	Provincia di Aydın
ܩܛܠܥܡܐ ܐܪܡܢܝܐ	Genocidio armeno
ܐܡܐܣܝܐ (ܗܘܦܪܟܝܐ)	Provincia di Amasya
ܦܪܝܙܘܢ ܒܪܝܟ	Prison Break
ܐܓܪܝ (ܗܘܦܪܟܝܐ)	Provincia di Ağrı
ܒܘܪܕܘܪ (ܗܘܦܪܟܝܐ)	Provincia di Burdur
ܐܓܪܬܐ ܩܕܡܝܬܐ ܕܠܘܬ ܩܘܪܢܬܝܐ	Prima lettera ai Corinzi
ܝܗܘܕܐ ܣܟܪܝܘܛܐ	Giuda Iscariota
ܐܒܪܐ	Piumaggio
ܡܚܪܐ	Ingegnere
ܚܪܛܘܡܢܐ	Cicer arietinum
ܐܬܪܘܬܐ ܕܫܐܡ	Levante (geografia)
ܬܪܘܕܐ	Cucchiaio
ܓܒܪܐܝܠ (ܡܠܐܟܐ)	Arcangelo Gabriele
ܓܪܡܦܝܠܐ	Avorio
ܨܘܪ	Tiro (città)
ܒܘܠܘ (ܗܘܦܪܟܝܐ)	Provincia di Bolu
ܙܢܩܐ	Mento
ܨܘܡܐ ܕܐܪܒܥܝܢ	Quaresima
ܐܓܪܐ ܕܒܢܝܢܐ	Copertura
ܒܝܛܠܝܣ (ܗܘܦܪܟܝܐ)	Provincia di Bitlis
ܓܠܝܠܐ	Galilea
ܪܥܡܐ	Tuono
ܡܘܨܠ	Mossul
ܟܪܬܐ	Pollice (dito)
ܦܐܦܐ ܫܢܘܕܐ ܬܠܝܬܝܐ	Shenuda III di Alessandria
ܒܝܬ ܓܘܣܐ	Bunker
ܒܝܥܬܐ	Uovo (alimento)
ܒܣܕܝܐ	Cuscino
ܙܓܐ (ܢܩܘܫܐ)	Campana
ܫܒܬܐ (ܝܗܘܕܝܘܬܐ)	Shabbat
ܫܡܝܪܡ	Semiramide
ܫܝܓܪܐ	Gengiva
ܝܗ	Tetragramma biblico
ܡܫܝܚܝܐ	Cristiano (religione)
ܟܪܘܙܘܬܐ ܕܡܪܩܘܣ	Vangelo secondo Marco
ܟܟܪܝܬܐ ܕܕܒܫܐ	Favo
ܐܓܪܬܐ ܕܠܘܬ ܩܘܪܢܬܝܐ ܕܬܪܬܝܢ	Seconda lettera ai Corinzi
ܫܥܘܬܐ (ܡܠܘܐܐ)	Cera
ܛܥܡܐ	Gusto
ܓܢܬ ܫܒܪܐ	Scuola dell'infanzia
ܝܡܬܐ ܕܓܠܝܠܐ	Lago di Tiberiade
ܕܝܘܬܐ	Inchiostro
ܡܪܝ ܝܘܣܦ	San Giuseppe
ܠܘܩܐ ܐܘܢܓܠܣܛܐ	Luca evangelista
ܐܓܪܬܐ ܕܠܘܬ ܥܒܪܝܐ	Lettera agli Ebrei
ܐܓܪܬܐ ܕܠܘܬ ܓܠܛܝܐ	Lettera ai Galati
Ϝ	Digamma
Ϙ	Qoppa
ܥܛܡܐ	Coscia
ܬܢܢܐ	Fumo
ܡܘܚܘܢܐ	Cervelletto
ܐܓܪܬܐ ܕܠܘܬ ܩܘܠܣܝܐ	Lettera ai Colossesi
ܐܓܪܬܐ ܕܝܥܩܘܒ	Lettera di Giacomo
ܐܓܪܬܐ ܩܕܡܝܬܐ ܕܝܘܚܢܢ	Prima lettera di Giovanni
ܐܓܪܬܐ ܕܠܘܬ ܦܝܠܡܘܢ	Lettera a Filemone
ܐܓܪܬܐ ܕܠܘܬ ܬܣܠܘܢܝܩܝܐ ܕܬܪܬܝܢ	Seconda lettera ai Tessalonicesi
ܐܓܪܬܐ ܩܕܡܝܬܐ ܕܠܘܬ ܬܣܠܘܢܝܩܝܐ	Prima lettera ai Tessalonicesi
ܐܓܪܬܐ ܩܕܡܝܬܐ ܕܦܛܪܘܣ	Prima lettera di Pietro
ܐܓܪܬܐ ܕܬܪܬܝܢ ܕܦܛܪܘܣ	Seconda lettera di Pietro
ܐܓܪܬܐ ܩܕܡܝܬܐ ܕܠܘܬ ܛܝܡܬܐܘܣ	Prima lettera a Timoteo
Ϛ	Stigma (lettera)
ܡܪܕܝܢ (ܗܘܦܪܟܝܐ)	Provincia di Mardin
ܚܡܨ (ܡܕܝܢܬܐ)	Homs
Ͳ	Sampi
ܘܐܟܐܩܐ ܕܝ ܟܘܐܪܝܣ	Oaxaca de Juárez
ܐܓܪܬܐ ܕܬܪܬܝܢ ܕܝܘܚܢܢ	Seconda lettera di Giovanni
ܐܓܪܬܐ ܕܬܠܬ ܕܝܘܚܢܢ	Terza lettera di Giovanni
ܐܓܪܬܐ ܕܝܗܘܕܐ	Lettera di Giuda
ܐܓܪܬܐ ܕܠܘܬ ܛܝܡܬܐܘܣ ܕܬܪܬܝܢ	Seconda lettera a Timoteo
ܐܓܪܬܐ ܕܠܘܬ ܛܛܘܣ	Lettera a Tito
ܫܝܪܢܐܟ (ܡܕܝܢܬܐ)	Şırnak
ܐܟܪܐ	Agricoltore
ܓܘܣܢܐ	Rifugiato
Ϻ	San (lettera)
ܩܠܝܕܐ (ܡܐܢܐ)	Chiave (serratura)
ܥܕܥܐܕܐ	Festival (antropologia)
ܐܪܒܝܠ (ܡܕܝܢܬܐ)	Arbil
ܪܓܠܐ	Zampa
ܚܨܐ	Schiena
ܐܠܝܐ ܢܒܝܐ	Elia
ܙܚܘܪܝܬܐ (ܬܘܠܥܬܐ)	Bombyx mori
ܚܘܦܝܐ	Eclissi
ܡܚܛܐ	Ago (cucito)
ܥܠܡܐ ܥܪܒܝܐ	Mondo arabo
ܦܓܘܕܬܐ	Testiera
ܩܛܡܐ	Cenere
ܢܘܗܕܪܐ (ܡܕܝܢܬܐ)	Dahuk
ܢܓܪܘܬܐ	Falegname
ܠܘܚܐ (ܚܫܘܒܬܐ)	Tablet computer
ܪܒܝܬܐ	Usura
ܡܟܝܪܘܬܐ	Promessa di matrimonio
ܫܘܪܡܐ	Retto
ܐܪܡܝܐ (ܢܒܝܐ)	Geremia
ܬܐܡܐ	Gemelli (biologia)
ܬܠܝܦܐ	Ciglia (occhi)
ܫܥܬܐ ܕܐܪܥܐ	Ora della Terra
ܦܪܡܝܬܐ	Bottone
ܟܘܟܒܐ ܕܕܘܝܕ	Stella di David
ܡܪܝ ܐܣܛܦܢܘܣ	Stefano protomartire
ܡܫܡܫܢܐ	Diacono
ܢܓܒ	Deserto del Negev
ܟܢܥܢ	Canaan
ܢܘܨܦܐ	Crepuscolo
ܒܝܢܐ	Tamarix
ܬܓܪܝܬ	Tikrit
ܚܠܐ (ܥܦܪܐ)	Polvere
ܬܪܥܐ ܕܕܡܐ	Emorragia
ܥܪܒܐ ܕܫܡܫܐ	Tramonto
ܐܡܝܫܐ	Palude
ܡܨܥܝܬܐ (ܨܒܥܐ)	Dito medio
ز	Zāy
ܣܒܐ (ܒܝܬܝܘܬܐ)	Nonno
ܩܘܪܨܠܐ	Caviglia
ܒܪ ܐܝܕܐ	Guanto
ܢܫܒܐ ܕܥܝܢܐ	Retina
ܬܘܩܢ ܓܝܕܝܐ ܡܚܕܘܪܝܐ	Sistema nervoso periferico
ܛܝܢܐ	Fango
ܓܓܘܠܬܐ	Calvario
ܗܢܝܢܐ (ܡܡܫܚܘܬܐ)	Interesse
ܐܫܘܪ ܒܢܐܦܠ	Assurbanipal
ܓܕܫܐ	Incidente
ܦܛܪܝܪܟܐ	Patriarca (cristianesimo)
ا	Alif
ܚܟܐ	Palato
ت	Tāʼ
ث	Ṯāʼ
ج	Ǧīm
ح	Ḥāʾ
خ	Ḫāʾ
د	Dāl
ذ	Ḏāl
ر	Rāʼ
س	Sīn
ܟܪܟ ܣܠܘܟ (ܡܕܝܢܬܐ)	Kirkuk
ܒܒܬܐ	Pupilla
ܩܒܪܐ	Tomba
ܠܒܘܢܬܐ	Franchincenso
ܚܡܬ (ܡܕܝܢܬܐ)	Hama
ܝܫܛܐ	Esofago
ܟܝܣܐ ܕܐܫܟܐ	Scroto
ܕܒܪܐ	Campagna
ܚܪܘܫܬܐ	Trachea
ܓܪܡܐ ܕܥܛܡܐ	Femore
ܒܪܐ (ܒܝܬܝܘܬܐ)	Figlio
ܫܚܘܪܐ	Carbone vegetale
ܐܘܟܡܐ ܕܥܝܢܐ	Iride (anatomia)
ܫܦܠܘܗܝ ܕܢܝܠܘܣ	Delta del Nilo
ܐܘܪܡܝܐ	Urmia
Ϸ	Sho (lettera)
ܓܙܪܬܐ ܐܝܘܠܝܬܐ	Isole Eolie
ܓܒܐ ܕܒܥܬ	Partito Ba'th
ܦܩܪܐ	Vertebra
ܒܪ ܩܠܐ	Eco (fisica)
ܟܝܡܪܐ	Chimera (mitologia)
ܠܘܓܡܐ	Osso mascellare
ܛܪܘܢܐ	Dittatore
ܬܝܒܘܬܐ	Penitenza (sacramento)
ܡܛܘܚܬܐ	Indice (dito)
ܩܒܠܘܬܐ	Ostetrica
ܐܪܙܝܪܐ	Sturnidae
ܣܦܪܐ (ܩܢܘܢܝܐ)	Giurista
Ͱ	Heta (lettera)
ܥܡܐ ܐܪܡܝܐ	Aramei
ܟܢܘܢܬܐ (ܫܪܝܬܐ)	Polso
ܐܒܐ (ܐܠܗܐ)	Dio Padre
ܐܢܒܐܪ (ܗܘܦܪܟܝܐ)	Governatorato di al-Anbar
ܡܪܕܝܢ (ܡܕܝܢܬܐ)	Mardin
ܣܪܛܢܐ	Cancer
ܡܘܪܘܢ	Confermazione
ܚܠܡܬܐ	Capezzolo
ܢܘܠܐ ܕܓܘܓܝ	Ragnatela
ܐܫܥܝܐ	Isaia
ܒܪܬ ܙܘܓܐ (ܒܝܬܝܘܬܐ)	Moglie
ܒܝܬ ܟܬܒܐ ܐܬܪܝܐ ܕܐܣܪܐܝܠ	Biblioteca nazionale di Israele
ܥܪܫܐ	Molare
ܢܝܢܘܐ (ܗܘܦܪܟܝܐ)	Governatorato di Ninawa
ܢܘܗܕܪܐ (ܗܘܦܪܟܝܐ)	Governatorato di Dahuk
ܘܐܣܛ (ܗܘܦܪܟܝܐ)	Governatorato di Wasit
ܨܠܐܚ ܐܠܕܝܢ (ܗܘܦܪܟܝܐ)	Governatorato di Salah al-Din
ܟܢܘܫܝܐ ܕܠܫܢܐ ܥܒܪܝܐ	Accademia della lingua ebraica
ܥܘܕ	Oud
ܒܓܕܐܕ (ܗܘܦܪܟܝܐ)	Governatorato di Baghdad
ܒܨܪܐ (ܨܒܥܐ)	Anulare
ܩܛܝܣܦܘܢ	Ctesifonte
ܟܒܘܫܐ	Incubo (sogno)
ܢܓܦ (ܗܘܦܪܟܝܐ)	Governatorato di al-Najaf
ܟܪܟ ܣܠܘܟ (ܗܘܦܪܟܝܐ)	Governatorato di Kirkuk
ܕܢܚܐ ܕܫܡܫܐ	Alba (giorno)
ܬܐܪܬܐ	Coscienza morale
ܒܨܪܐ (ܗܘܦܪܟܝܐ)	Governatorato di Bassora
ܡܫܚܐ ܕܟܪܝܗܐ	Unzione degli infermi
ܦܠܫܬ	Filistei
ܐܠܥܐ (ܝܘܠܦܢ ܨܪܘܝܘܬܐ)	Costa (anatomia)
ܥܕܬܐ ܐܝܓܘܦܛܝܬܐ	Chiesa ortodossa copta
ܐܢܛܝܘܟܝܐ	Antiochia di Siria
ܐܦܪܝܡ ܣܘܪܝܝܐ	Efrem il Siro
ܪܝܫܘܢ ܠܬܣܝܘܢ	Rishon LeZion
ܟܢܪܐ	Lira (strumento musicale)
ܥܕܬܐ ܕܡܕܢܚܐ ܕܐܬܘܪܝܐ	Chiesa assira d'Oriente
ܬܠܐ ܕܚܕ ܐܝܠܢ	One Tree Hill
ܡܘܪܐ	Mirra
ܦܕܪܠܝܐ	Federalismo
ܐܠܝܫܥ	Eliseo (profeta)
ܗܟܐܪܝ (ܡܕܝܢܬܐ)	Hakkâri
ܣܢܚܪܝܒ	Sennacherib
ܩܘܪܝܐܠܝܣܘܢ	Kyrie eleison
ܟܢܘܫܝܐ ܕܐܣܪܐܝܠ ܕܝܘܠܦܢܐ ܘܐܢܫܝܬܐ	Accademia israeliana delle scienze e delle lettere
ܣܘܟܢܐ	Timone (nautica)
ܥܕܬܐ ܣܘܪܝܝܬܐ ܐܪܬܘܕܟܣܝܬܐ	Chiesa ortodossa siriaca
ܟܣܬܐ	Mangime
ܩܡܫܠܝ	Kamishlié
ܡܘܬܢܐ (ܗܘܦܪܟܝܐ)	Governatorato di al-Muthanna
ܒܪ ܙܘܓܐ (ܒܝܬܝܘܬܐ)	Marito
ܡܝܫܢ (ܗܘܦܪܟܝܐ)	Governatorato di Maysan
ܣܘܠܝܡܐܢܝܐ (ܗܘܦܪܟܝܐ)	Governatorato di al-Sulaymaniyya
ܐܪܒܝܠ (ܗܘܦܪܟܝܐ)	Governatorato di Erbil
ܚܠܒ (ܗܘܦܪܟܝܐ)	Governatorato di Aleppo
ܟܪܒܠܐܐ (ܗܘܦܪܟܝܐ)	Governatorato di Karbala
ܦܪܨܘܦܐ	Persona (filosofia)
ܕܝ ܩܐܪ (ܗܘܦܪܟܝܐ)	Governatorato di Dhi Qar
ܐܢܕܪܢܝܩ ܡܐܪܓܐܪܝܐܢ	Andranik Margaryan
ܡܡܠܠܘܬ ܐܠܗܘܬܐ	Teologia cristiana
ܓܘܙܐ	Juglandaceae
ܕܝܐܠܐ (ܗܘܦܪܟܝܐ)	Governatorato di Diyala
ܟܒܒ	Khabab
ش	Šīn
ܩܪܫܬܐ	Soffitto
ص	Ṣād
ض	Ḍād
ظ	Ẓāʼ
ع	ʿayn
غ	Ġayn
ف	Fā
ق	Qāf
ܚܨܪܐ	Mignolo
ܐܡܬܐ (ܝܘܠܦܢ ܨܪܘܝܘܬܐ)	Avambraccio
ܣܝܢܝ	Sinai
ܬܐܘܡܐ	Thomas
ܐܝܒܪܝܐ	Iberia
ܚܡܬ (ܗܘܦܪܟܝܐ)	Governatorato di Hama
ܟܢܘܢܬܐ ܕܐܝܕܐ	Carpo
ܐܝܣܪܐܝܠ (ܬܘܚܡܐ ܐܚܪܢܐ)	Israel
ܡܠܐܟܐ	Angelo
ܡܣܘܪܩܐ ܕܐܝܕܐ	Metacarpo
ܡܠܟܘܬܐ ܕܒܝܬ ܥܣܪ ܥܝܢܐ	Osroene
ܕܪܥܐ (ܡܕܝܢܬܐ)	Dar'a
ܣܘܣܝܐ ܐܝܣܠܢܕܝܐ	Cavallo islandese
ܩܠܐ	Nota musicale
ܓܪܡܐ	Osso
ܒܪܝܐܢܝ	Biryani
ܠܒܠܒܬܐ	Ugola
ك	Kāf
ل	Lām
م	Mīm
ن	Nūn
ه	Hāʼ
و	Wāw (lettera)
ي	Yāʼ
ܥܪܒܝܐ	Arabo
ܓܝܕܐ ܕܓܢܫܝܐ	Nervo ischiatico
ܗܪܗܪܐ	Miraggio
ܒܝܬ ܢܗܪܝܢ ܥܠܝܬܐ	Giazira
ܛܐܪܩ ܥܙܝܙ	Tareq Aziz
ܡܣܘܪܩܐ ܕܪܓܠܐ	Metatarso
ܥܪܩ	Arak
ܫܠܦܐ	Lama (oggetto)
ܛܘܪ ܠܒܢܢ	Monte Libano
ܩܪܕܘܝܐ	Curdo
ܪܗܘܡܐ	RUM
ܓܐܝܘܣ	Gaio (nome)
ܩܝܒܩ	Québec
ܩܕܠܐ	Nuca
ܥܡܐ ܐܬܘܪܝܐ/ܣܘܪܝܝܐ	Assiri (gruppo etnico)
ܛܘܪܐ ܕܣܝܢܝ	Monte Sinai
ܦܘܪܬܥܢܐ	Siphonaptera
ܟܪܘܙܘܬܐ ܕܡܬܝ	Vangelo secondo Matteo
ܡܕܝܢܬܐ ܡܝܬܬܐ	Antichi villaggi della Siria settentrionale
ܐܓܪܬܐ ܕܠܘܬ ܐܦܣܝܐ	Lettera agli Efesini
ܚܡܬ	Hama (disambigua)
10000 (ܡܢܝܢܐ)	10000
ܒܢܦܫܐ	Viola (colore)
ܢܨܪܬ	Nazaret
ܟܬܒܐ ܕܡܘܪܡܘܢ	Libro di Mormon
ܐܝܓܢܐܛܝܘܣ ܡܘܫܐ ܩܕܡܝܐ ܕܐܘܕ	Ignazio Mosé I Daoud
ܒܫܐܪܐ ܦܛܪܘܣ ܐܠܪܐܥܝ	Béchara Boutros Raï
ܥܡܢܘܐܝܠ ܬܠܝܬܝܐ ܕܠܝ	Emmanuel III Delly
ܥܡܘ ܒܒܐ	Ammo Baba
ܥܡܘܕܐ ܦܩܪܝܐ	Colonna vertebrale
ܒܝܬ ܫܥܝܐ	Stadio
ܓܘܕ ܫܪܠܘܛ	Good Charlotte
ܒܪ ܨܘܪܐ	Colletto (abbigliamento)
ܚܣܚܘܣܐ	Tessuto cartilagineo
ܛܘܪ ܥܒܕܝܢ	Tur Abdin
ܡܪܝ ܩܘܪܝܩܘܣ ܣܗܕܐ ܘܕܝܘܠܝܛܐ ܝܡܗ	Quirico e Giulitta
ܐܝܣܛܢܒܘܠ (ܗܘܦܪܟܝܐ)	Provincia di Istanbul
ܝܘܢܝܐ	Greci
ܓܗܢܐ	Geenna
ܝܥܩܘܒ ܒܘܪܕܥܢܐ	Giacomo Baradeo
ܐܓܢܛܝܘܣ ܝܘܣܦ ܬܠܝܬܝܐ ܝܘܢܢ	Ignazio Giuseppe III Younan
ܬܐܓܘܪܬܐ	Commercio
ܡܬܐ	Heimat
ܫܝܪܢܐܟ (ܗܘܦܪܟܝܐ)	Provincia di Şırnak
ܥܘܩܣܐ	Pungiglione
ܟܗܢܘܬܐ	Ordine sacro
ܚܒܘܪ	Khabur
ܗܕܡܐ ܓܘܝܐ	Organo (anatomia)
ܡܥܠܘܠܐ	Ma'lula
ܐܘܪܘܦܐ	Europa (disambigua)
ܡܕܝܕ	Midyat
ܐܣܝܪܝܣܩܐ	Assyriska Fotbollsföreningen
ܥܕܬܐ ܣܘܪܝܝܬܐ ܩܬܘܠܝܩܝܬܐ	Chiesa cattolica sira
ܐܘܣܛܪܠܝܐ	Australia (disambigua)
ܡܦܩܬܐ ܦܫܝܛܬܐ	Peshitta
ܐܪܚܘܬܐ	Ospitalità
ܚܘܐ	Eva
ܩܛܠܥܡܐ ܐܬܘܪܝܐ	Genocidio assiro
ܒܝܬ ܟܬܒܐ ܕܐܫܘܪ ܒܢܐܦܠ	Biblioteca di Assurbanipal
ܒܕܘܩܐ	Scautismo
ܥܘܕܪܢܐ:ܚܒܝܫܬ̈ܐ	Aiuto:Aiuto
ܓܦܬܐ	Pianta rampicante
ܡܝܟܐܝܠ	Michael
ܐܣܛܘܡܟܐ	Stomaco
ܟܢܘܢܬܐ ܕܪܓܠܐ	Tarso (scheletro)
ܓܢܬܐ	Giardino
ܒܪܐ (ܐܠܗܐ)	Dio Figlio
ܚܝܠܐ ܠܒܢܝܐ	Forze Libanesi
ܐܠܩܘܫ	Alqosh
ܐܘܪܗܝ	Edessa (Mesopotamia)
ܘܝܩܝܦܕܝܐ:ܐܝܙܓܕܘܬܐ	Wikipedia:Ambasciata
ܫܠܝܬܐ	Placenta
ܒܝܬ ܛܘܣܐ	Aeroporto
ܒܝܬ ܫܡܪܝܐ	Samaria
ܐܓܢܣ ܡܘ	Agnes Monica
ܪܘܦܐܝܠ ܩܕܡܝܐ ܒܝܬ ܕܘܝܕ	Rafael I Bidawid
ܓܝܠܒܪܛܘ ܩܘܢܣܦܣܝܘܢ ܕܗ ܓܪܣܝܐ	Gilberto Concepcion de Gracia
ܣܕܪܐ:ܓܪܡܢ	Categoria:Germania
ܣܕܪܐ:ܐܝܛܠܝܐ	Categoria:Italia
ܣܕܪܐ:ܐܬܪܘܬܐ ܡܚܝܕܐ ܕܐܡܪܝܩܐ	Categoria:Stati Uniti d'America
ܣܕܪܐ:ܪܘܣܝܐ	Categoria:Russia
ܣܕܪܐ:ܩܢܕܐ	Categoria:Canada
ܣܕܪܐ:ܐܝܣܪܐܝܠ	Categoria:Israele
ܣܕܪܐ:ܛܘܪܩܝܐ	Categoria:Turchia
ܣܕܪܐ:ܡܨܪܝܢ	Categoria:Egitto
ܣܕܪܐ:ܐܝܪܐܢ	Categoria:Iran
ܥܐܕܐ	Giorno festivo
ܣܕܪܐ:ܥܝܪܐܩ	Categoria:Iraq
ܣܕܪܐ:ܗܘܠܢܕܐ	Categoria:Paesi Bassi
ܣܕܪܐ:ܦܘܠܢܕ	Categoria:Polonia
ܣܕܪܐ:ܛܝܪܐ	Categoria:Uccelli
ܣܕܪܐ:ܝܥܝܬܐ	Categoria:Piante
ܣܕܪܐ:ܬܘܕܝܬܐ	Categoria:Religione
ܣܕܪܐ:ܝܕܥܬܐ	Categoria:Scienza
ܨܘܒܐ	Nisibis
ܕܪܥܐ (ܗܘܦܪܟܝܐ)	Governatorato di Dar'a
ܣܕܪܐ ܕܦܛܪܝܪܟܐ ܕܥܕܬܐ ܕܡܕܢܚܐ	Patriarchi della Chiesa assira d'Oriente
ܢܩܘܕ	Niqqud
ܡܪܝܡ (ܚܬܗ ܕܡܘܫܐ)	Miriam (Esodo)
ܣܕܪܐ:ܬܘܚܡܐ ܐܚܪܢܐ	Categoria:Pagine di disambiguazione
ܣܕܪܐ:ܡܫܝܚܝܘܬܐ	Categoria:Cristianesimo
ܣܕܪܐ:ܐܣܠܐܡ	Categoria:Islam
ܣܕܪܐ:ܝܗܘܕܝܘܬܐ	Categoria:Ebraismo
ܠܩܐ ܕܣܦܝܢܬܐ	Remo (attrezzo)
ܚܪܒܘܩܬܐ	Occhiello (moda)
ܫܡܥܘܢ ܒܪܨܒܥܐ	Simone bar Sabbae
ܙܚܘܪܝܬܐ (ܓܘܢܐ)	Scarlatto
ܐܢܩܪܐ (ܗܘܦܪܟܝܐ)	Provincia di Ankara
ܐܝܪܠܢܕ	Irlanda (disambigua)
ܝܘܢܢ	Giona (profeta)
ܐܨܪܐ	Condimento
ܡܪܩܩܐ	Ipocondrio
ܫܘܫܡܬܐ	Sesamum indicum
ܣܕܪܐ:ܝܒܫܬܐ	Categoria:Continenti
ܝܙܦܬܐ	Debito
ܦܨܝܕܐ	Stagno (acqua)
ܐܪܓܘܢܐ	Porpora
ܢܘܪܢܝܐ	Piramide (geometria)
ܘܝܩܝܦܕܝܐ:HotCat	Aiuto:Accessori/HotCat
ܒܛܐ	Anatra
ܗܝܟܠܐ ܕܫܠܝܡܘܢ	Tempio di Gerusalemme
ܠܘܝܣ ܪܘܦܐܝܠ ܩܕܡܝܐ ܣܟܘ	Louis Raphaël I Sako
ܣܕܪܐ:ܡܟܬܒܢܘܬܐ ܕܐܬܪܘܬܐ	Categoria:Nazioni
ܘܝܩܝܦܕܝܐ:ܡܕܒܪܢܐ	Wikipedia:Amministratori
ܣܕܪܐ:ܫܕܬܐ	Categoria:Professioni
ܘܝܩܝܦܕܝܐ:ܒܘܬ̈ܐ	Wikipedia:Bot
ܣܕܪܐ:ܙܒܢܐ	Categoria:Tempo
ܣܕܪܐ:ܝܘܠܦܢ ܨܪܘܝܘܬܐ	Categoria:Anatomia
ܣܕܪܐ:ܐܣܝܘܬܐ	Categoria:Medicina
ܡܨܪܝܢ	Egitto
ܩܠܒܐ:Bot	Template:Bot
ܩܢܕܐ	Canada
ܣܕܪܐ:ܝܘܢ	Categoria:Grecia
ܣܕܪܐ:ܣܘܝܕ	Categoria:Svezia
ܩܠܒܐ:ܐܫܛܪܘܬܐ	Template:Man
ܣܕܪܐ:User languages	Categoria:Utenti per lingua
ܦܘܠܚܢܐ	Business
ܩܠܒܐ:Softredirect	Template:Soft redirect
ܩܠܒܐ:Delete	Template:Cancella subito
ܡܓܕܠܐ (ܩܪܝܬܐ)	Magdala (Israele)
ܣܕܪܐ:ܛܟܢܘܠܘܓܝܐ	Categoria:Tecnologia
ܣܕܪܐ:ܠܫܢܐ	Categoria:Lingue
ܣܕܪܐ:ܩܢܘܢܐ ܕܠܥܙܐ	Categoria:Grammatica
ܘܝܩܝܦܕܝܐ:General disclaimer	Wikipedia:Avvertenze generali
ܣܕܪܐ:Noindexed pages	Categoria:Pagine non indicizzate
ܘܝܩܝܦܕܝܐ:ܕܘܒܪܐ	Aiuto:Manuale di stile
ܩܠܒܐ:Navbox	Template:Navbox
ܣܕܪܐ:ܩܠܒܐ ܐܬܘܬܐ ܕܐܝܣܘ	Categoria:Template bandierine
ܩܠܒܐ:ܡܦܐܬܐ ܩܠܒܐ	Template:Tnavbar
ܩܠܒܐ:Clear	Template:Clear
ܘܝܩܝܦܕܝܐ:ܡܟܬܒܘܬܐ ܕܡܓܠܐ ܠܟܠ ܘܝܩܝܦܕܝܐ	Wikipedia:Lista delle voci che tutte le Wikipedie dovrebbero avere
ܣܕܪܐ:ܐܠܝܩܛܪܘܢܝܘܬܐ	Categoria:Elettronica
ܣܕܪܐ:ܝܪܚܐ ܕܫܢܬܐ	Categoria:Mesi dell'anno
ܩܠܒܐ:Babel	Template:Babel
ܩܠܒܐ:Commons	Template:Commons
ܩܠܒܐ:Reflist	Template:References
ܩܠܒܐ:User ar-1	Template:Utente ar-1
ܩܠܒܐ:User az	Template:Utente az
ܩܠܒܐ:See also	Template:Vedi anche
ܩܠܒܐ:User de	Template:Utente de
ܩܠܒܐ:User es	Template:Utente es
ܩܠܒܐ:User en-3	Template:Utente en-3
ܩܠܒܐ:User en-1	Template:Utente en-1
ܩܠܒܐ:User en-2	Template:Utente en-2
ܩܠܒܐ:User en-4	Template:Utente en-4
ܩܠܒܐ:User en-0	Template:Utente en-0
ܩܠܒܐ:User en	Template:Utente en
ܩܠܒܐ:User fa	Template:Utente fa
ܩܠܒܐ:User fr-1	Template:Utente fr-1
ܩܠܒܐ:User he-2	Template:Utente he-2
ܩܠܒܐ:User he-1	Template:Utente he-1
ܩܠܒܐ:User sk	Template:Utente sk
ܩܠܒܐ:User tr	Template:Utente tr
ܩܠܒܐ:User ja	Template:Utente ja
ܩܠܒܐ:User fr	Template:Utente fr
ܩܠܒܐ:User he	Template:Utente he
ܣܕܪܐ:ܐܣܝܐ	Categoria:Asia
ܣܕܪܐ:ܕܪܐ ܕܥܣܪܝܢ ܘܚܕ	Categoria:XXI secolo
ܩܠܒܐ:Mod	Template:Mod
ܩܠܒܐ:User sv	Template:Utente sv
ܩܠܒܐ:User it	Template:Utente it
ܣܕܪܐ:ܝܘܡܐ ܕܫܒܘܥܐ	Categoria:Giorni della settimana
ܣܕܪܐ:ܐܨܪܐ	Categoria:Condimenti
ܩܠܒܐ:Sidebar	Template:Sidebar
ܩܠܒܐ:Ambox	Template:Avviso
ܩܠܒܐ:ܐܬܪܐ	Template:Stato
ܩܠܒܐ:/box-header	Template:Box-testata
ܣܕܪܐ:User en	Categoria:Utenti en
ܣܕܪܐ:User zh	Categoria:Utenti zh
ܩܠܒܐ:ܐܠܦܒܝܬ ܥܪܒܝܐ	Template:Alfabeto arabo
ܣܕܪܐ:User zh-N	Categoria:Utenti zh-M
ܩܠܒܐ:ܨܢܕܘܩ ܪܡܙܐ2	Template:Infobox
ܩܠܒܐ:User zh	Template:Utente zh
ܣܕܪܐ:ܦܐܦܐ	Categoria:Papi
ܩܠܒܐ:Pp-template	Template:Pp-template
ܩܠܒܐ:User nl-1	Template:Utente nl-1
ܩܠܒܐ:User nl-2	Template:Utente nl-2
ܩܠܒܐ:User ru	Template:Utente ru
ܩܠܒܐ:IPA	Template:IPA
ܣܕܪܐ:ܗܪܘܡܐ	Categoria:Spezie
ܣܕܪܐ:ܦܠܫܬ	Categoria:Palestina
ܣܕܪܐ:ܡܠܐܟܐ	Categoria:Angeli
ܣܕܪܐ:ܢܒܝܐ	Categoria:Profeti
ܩܠܒܐ:Category redirect	Template:Categoria redirect
ܩܠܒܐ:ܨܢܕܘܩ ܡܕܒܪܢܐ	Template:Carica pubblica
ܩܠܒܐ:Sortname	Template:Sortname
ܩܠܒܐ:Border	Template:Border
ܩܠܒܐ:ܡܢܝܢܐ ܕܝܪܚܐ	Template:MONTHNUMBER
ܩܠܒܐ:GUA	Template:GTM
ܩܠܒܐ:User nl	Template:Utente nl
ܩܠܒܐ:ܡܣܦܩ ܩܐܫ	Template:Purga
ܩܠܒܐ:ܡܦܠܚܢܐ	Template:Utente
ܣܕܪܐ:ܬܘܢܣ	Categoria:Tunisia
ܩܠܒܐ:Oppose	Template:Contrario
ܩܠܒܐ:COL	Template:COL
ܩܠܒܐ:PER	Template:PER
ܩܠܒܐ:ܨܢܕܘܩ ܡܕܥܐ ܕܝܒܫܬܐ	Template:Regione geografica
ܩܠܒܐ:User ar-2	Template:Utente ar-2
ܩܠܒܐ:User ar-3	Template:Utente ar-3
ܩܠܒܐ:User ar	Template:Utente ar
ܩܠܒܐ:ܝܘܡܐ ܕܫܒܘܥܐ	Template:Giorni della settimana
ܣܕܪܐ:ܡܕܝܢܬܐ ܒܐܘܚܕܢܐ ܡܚܝܕܐ	Categoria:Città degli Stati Uniti d'America
ܩܠܒܐ:ܬ.ܐ.	Template:Disambigua
ܩܠܒܐ:No	Template:Non fatto
ܣܕܪܐ:ܩܠܒܐ ܨܢܕܘܩܐ	Categoria:Template sinottici
ܩܠܒܐ:UsersSpeak	Template:Utenti per lingua
ܩܠܒܐ:ܩܘܕܝܟܘܣ ܕܣܕܪܐ	Template:Indice categoria
ܣܕܪܐ:User yue	Categoria:Utenti yue
ܣܕܪܐ:User az	Categoria:Utenti az
ܣܕܪܐ:User sk	Categoria:Utenti sk
ܣܕܪܐ:User fr	Categoria:Utenti fr
ܣܕܪܐ:User ja	Categoria:Utenti ja
ܣܕܪܐ:User la	Categoria:Utenti la
ܣܕܪܐ:User pt	Categoria:Utenti pt
ܣܕܪܐ:User ro	Categoria:Utenti ro
ܣܕܪܐ:User sv	Categoria:Utenti sv
ܣܕܪܐ:User ko-N	Categoria:Utenti ko-M
ܣܕܪܐ:ܗܘܦܪܟܝܣ ܕܥܝܪܐܩ	Categoria:Governatorati dell'Iraq
ܣܕܪܐ:User ar	Categoria:Utenti ar
ܣܕܪܐ:User arc	Categoria:Utenti arc
ܣܕܪܐ:User da	Categoria:Utenti da
ܣܕܪܐ:User sk-N	Categoria:Utenti sk-M
ܣܕܪܐ:User de	Categoria:Utenti de
ܣܕܪܐ:User el	Categoria:Utenti el
ܣܕܪܐ:User en-N	Categoria:Utenti en-M
ܣܕܪܐ:User es	Categoria:Utenti es
ܣܕܪܐ:User fa	Categoria:Utenti fa
ܣܕܪܐ:User fi	Categoria:Utenti fi
ܣܕܪܐ:User he	Categoria:Utenti he
ܩܠܒܐ:N/a	Template:ND
ܣܕܪܐ:User hy	Categoria:Utenti hy
ܣܕܪܐ:ܠܫܢܐ ܥܒܪܝܐ	Categoria:Lingua ebraica
ܣܕܪܐ:User it	Categoria:Utenti it
ܣܕܪܐ:User ko	Categoria:Utenti ko
ܣܕܪܐ:ܝܡܡܐ	Categoria:Mari
ܩܠܒܐ:ܐܠܦܒܝܬ ܝܘܢܝܐ	Template:Alfabeto greco navbox
ܣܕܪܐ:ܦܛܪܝܪܟܘ ܕܥܕܬܐ ܣܘܪܝܝܬܐ ܩܬܘܠܝܩܝܬܐ	Categoria:Patriarchi di Antiochia dei Siri
ܩܠܒܐ:ܡܢܝܢܐ ܕܡܡܪܐ ܦܪܝܫܐ	Template:Numero voci in Vetrina
ܩܠܒܐ:Yes-No	Template:Forset
ܬܪܥܐ:ܬܘܕܝܬܐ	Portale:Religioni
ܣܕܪܐ:User ru	Categoria:Utenti ru
ܣܕܪܐ:User ru-3	Categoria:Utenti ru-3
ܣܕܪܐ:User tl	Categoria:Utenti tl
ܣܕܪܐ:User tr	Categoria:Utenti tr
ܣܕܪܐ:ܙܡܪܐ	Categoria:Musicisti
ܩܠܒܐ:Lang	Template:Lang
ܣܕܪܐ:ܪܫܘܡܐ	Categoria:Pittori
ܩܠܒܐ:ܫܠܝܚܐ ܕܡܫܝܚܐ	Template:Apostoli
ܩܠܒܐ:CHI	Template:CHL
ܣܕܪܐ:ܢܝܓܪ	Categoria:Niger
ܣܕܪܐ:ܦܛܪܝܪܟܘ ܕܥܕܬܐ ܕܡܕܢܚܐ	Categoria:Patriarchi della Chiesa assira d'Oriente
ܩܠܒܐ:User ar-0	Template:Utente ar-0
ܣܕܪܐ:ܣܥܪܐ	Categoria:Acconciature
ܣܕܪܐ:ܢܗܪܘܬܐ	Categoria:Fiumi
ܩܠܒܐ:User he-0	Template:Utente he-0
ܩܠܒܐ:User he-3	Template:Utente he-3
ܩܠܒܐ:User he-4	Template:Utente he-4
ܩܠܒܐ:User ko	Template:Utente ko
ܩܠܒܐ:User pt	Template:Utente pt
ܣܕܪܐ:User nl	Categoria:Utenti nl
ܣܕܪܐ:User no	Categoria:Utenti no
ܣܕܪܐ:ܣܘܪܝܐ	Categoria:Siria
ܣܕܪܐ:ܕܪܐ ܩܕܡܝܐ	Categoria:I secolo
ܣܕܪܐ:ܓܙܪܬܐ ܝܒܫܢܝܬܐ	Categoria:Penisole
ܣܕܪܐ:ܗܘܦܪܟܝܣ ܕܗܘܠܢܕܐ	Categoria:Province dei Paesi Bassi
ܣܕܪܐ:ܡܢܝܢܐ	Categoria:Numeri interi
ܣܕܪܐ:ܡܕܝܢܬܐ ܕܥܝܪܐܩ	Categoria:Città dell'Iraq
ܣܕܪܐ:ܥܝܢܐ (ܨܪܘܝܘܬܐ)	Categoria:Occhio
ܣܕܪܐ:ܓܘܪܓܝܐ	Categoria:Georgia
ܣܕܪܐ:ܟܘܘܝܬ	Categoria:Kuwait
ܣܕܪܐ:ܠܒܢܢ	Categoria:Libano
ܣܕܪܐ:ܪܝܫܝ ܩܘܛܢܝܘܬܐ ܕܐܬܪܘܬܐ ܡܚܝܕܐ ܕܐܡܪܝܩܐ	Categoria:Presidenti degli Stati Uniti d'America
ܣܕܪܐ:ܝܘܪܕܢܢ	Categoria:Giordania
ܣܕܪܐ:ܦܐܪܐ	Categoria:Frutta
ܣܕܪܐ:ܝܘܠܦܢ ܟܘܪܗܢܐ	Categoria:Patologia
ܣܕܪܐ:ܓܒܐ	Categoria:Partiti politici
ܣܕܪܐ:ܕܝܬܝܩܝ ܚܕܬܐ	Categoria:Nuovo Testamento
ܣܕܪܐ:ܕܝܬܝܩܝ ܥܬܝܩܬܐ	Categoria:Antico Testamento
ܣܕܪܐ:ܐܘܩܝܢܘ	Categoria:Oceani
ܣܕܪܐ:ܗܘܦܪܟܝܣ ܘܐܘܚܕܢܐ ܕܩܢܕܐ	Categoria:Province canadesi
ܣܕܪܐ:ܚܝܘܬܐ	Categoria:Animali
ܣܕܪܐ:ܛܘܪܐ	Categoria:Catene montuose
ܣܕܪܐ:ܣܘܥܪܢܐ	Categoria:Eventi
ܣܕܪܐ:ܟܘܪܗܢܐ	Categoria:Malattie
ܣܕܪܐ:User pl	Categoria:Utenti pl
ܣܕܪܐ:ܡܕܒܪܐ	Categoria:Deserti
ܣܕܪܐ:ܝܡܡܬܐ	Categoria:Laghi
ܩܠܒܐ:ܨܢܕܘܩ ܪܡܙܐ ܕܠܫܢܐ	Template:Lingua
ܣܕܪܐ:ܩܛܠܥܡܐ	Categoria:Stragi
ܨܝܢ	China
ܛܪܘܝܐܢܝ	Trojany
ܫܪܓܐ	LAMP
ܩܠܒܐ:User arc-3	Template:Utente arc-3
ܩܠܒܐ:User arc-1	Template:Utente arc-1
ܫܩܐ	Gamba
ܣܕܪܐ:ܦܛܪܝܪܟܘ ܕܥܕܬܐ ܟܠܕܝܬܐ ܩܬܘܠܝܩܝܬܐ	Categoria:Patriarchi di Babilonia dei Caldei
ܣܕܪܐ:ܦܛܪܝܪܟܘ	Categoria:Patriarchi
ط	Ṭāʼ
ܣܕܪܐ:ܒܝܬ ܟܬܒܐ	Categoria:Biblioteche
ܣܕܪܐ:ܒܝܬ ܢܗܪܝܢ	Categoria:Mesopotamia
ܣܕܪܐ:ܓܘܢܐ	Categoria:Colori
ܣܕܪܐ:ܦܣܩܐ ܕܝܘܡܐ	Categoria:Parti del giorno
ܩܠܒܐ:ܣܘܪܓܕܐ ܚܘܫܒܢܐ	Template:Anno in altri calendari
ܣܕܪܐ:ܩܕܝܫܐ	Categoria:Santi
ܩܪܕܐ (ܪܚܫܐ)	Ixodida
ܩܠܒܐ:ܣܝܩܘܡ ܫܘܪܝܐ	Template:Start date
ܩܠܒܐ:User nl-3	Template:Utente nl-3
ܬܪܥܐ:ܐܘܩܝܢܘܣܝܐ	Portale:Oceania
ܢܘܓܗܐ	Aurora (giorno)
ܕܝܠܢܝܐ:ܫܘܚܠܦ̈ܐ ܚܕ̈ܬܐ	Speciale:UltimeModifiche
ܘܙܐ	Oca
