Hĭ-ciŭ	Africa
Nĭk-buōng	Giappone
Nàng Mī-ciŭ	America Meridionale
Nò̤-ŭi	Norvegia
Ĭng-gáik-làng	Inghilterra
Sŭ-gáik-làng	Scozia
Ŭi-ī-sê̤ṳ	Galles
Báe̤k Ái-ī-làng	Irlanda del Nord
Ái-ī-làng	Irlanda
Hungary	Ungheria
Să̤-băng-ngà	Spagna
Mī-guók	Stati Uniti d'America
Bī-lé-sì	Belgio
Luxembourg	Lussemburgo
Ṳ̄-dêu	Universo
Dê-giù	Terra
Sĕng-mêng	Vita
Sī	Morte
Nè̤ng	Homo sapiens
Huăng-hī	Felicità
George Washington	George Washington
Wikidata	Wikidata
Hŭng-làng	Finlandia
Sôi-diēng	Svezia
Dăng-măk	Danimarca
Pŏ̤-làng	Polonia
Lithuania	Lituania
É-dâi-lé	Italia
Sô̤i-sê̤ṳ	Svizzera
Ó̤-dê-lé	Austria
Hĭ-lé-nà̤	Grecia
Tū-ī-gì	Turchia
Bì-ciū	Birra
Può-dò̤-ngà	Portogallo
Ĕu-ciŭ	Europa
Ā-ciŭ	Asia
Báe̤k Mī-ciŭ	America del Nord
Nàng-gĭk-ciŭ	Antartide
Wikipedia	Wikipedia
Hò̤-làng	Paesi Bassi
Ĭng-gĕng	Pene
PHP	PHP
Niū-iók-chê	New York
Washington, D.C.	Washington
Gô-gĭng-săng	San Francisco
Báik-lìng	Berlino
Los Angeles	Los Angeles
Diêng-nō̤	Computer
Sŭ-là̤-sié	Zurigo
Barack Obama	Barack Obama
Uruguay	Uruguay
MediaWiki	MediaWiki
Lùng-dŭng	Londra
Bìng-guō	Mela
Bă-là̤	Parigi
Mĕ̤k-să̤-gŏ̤	Messico
Dâi-să̤-iòng	Oceano Atlantico
Tái-bìng-iòng	Oceano Pacifico
California	California
Boston	Boston
Lā̤-bái-ék	Lunedì
Huōi-sĭng	Marte (astronomia)
Kenya	Kenya
Ethiopia	Etiopia
Gŭng-ciō (nguòng-siū)	Monarca
Ghana	Ghana
Lā̤-bái-nê	Martedì
Lā̤-bái-săng	Mercoledì
Lā̤-bái-sé	Giovedì
Lā̤-bái-ngô	Venerdì
Lā̤-bái-lĕ̤k	Sabato
Lā̤-bái-nĭk	Domenica
Săi (mà-kuŏ dông-ŭk)	Panthera leo
Huák-guók	Francia
Kēng	Canis lupus familiaris
Ĭng-guók	Regno Unito
Mà	Felis silvestris catus
Dṳ̆ng-huà Ìng-mìng Gê̤ṳng-huò-guók	Cina
Huák-ngṳ̄	Lingua francese
Wiktionary	Wikizionario
Ngṳ̀	Pesce
Ciū	Bevanda alcolica
Bă-să̤	Brasile
Ngò̤-lò̤-sṳ̆	Russia
Hāi	Mare
Alabama	Alabama
Wikimedia	Wikimedia Foundation
Jimmy Wales	Jimmy Wales
Dáik-guók	Germania
Belarus	Bielorussia
Dáik-ngṳ̄	Lingua tedesca
Bĭng-dō̤	Islanda
Estonia	Estonia
Tū-sĭng	Saturno (astronomia)
Hĭ-gĭ	Aeroplano
Ciéng-cĕng	Guerra
1	1 (numero)
2	2 (numero)
3	3 (numero)
4	4 (numero)
5	5 (numero)
0	0 (numero)
George W. Bush	George W. Bush
Latvia	Lettonia
Ukraine	Ucraina
Ciék-káik	Repubblica Ceca
Slovakia	Slovacchia
Slovenia	Slovenia
Moldova	Moldavia
Romania	Romania
Bulgaria	Bulgaria
Lò̤-mā	Roma
Macedonia Gê̤ṳng-huò-guók	Repubblica di Macedonia
Albania	Albania
Croatia	Croazia
Bosnia gâe̤ng Herzegovina	Bosnia ed Erzegovina
Azerbaijan	Azerbaigian
Andorra	Andorra
Cyprus	Cipro
Georgia (guók-gă)	Georgia
Kazakhstan	Kazakistan
Malta	Malta
Monaco	Principato di Monaco
Montenegro	Montenegro
Vaticano	Città del Vaticano
San Marino	San Marino
Gū-bă	Cuba
Belize	Belize
Barbados	Barbados
Java	Java (linguaggio di programmazione)
Éng-dô-nà̤-să̤-ā	Indonesia
Tū-ī-gì-ngṳ̄	Lingua turca
Nàng-hĭ	Sudafrica
Algeria	Algeria
Wiki Dù-cṳ̆-guāng	Wikisource
Uzbekistan	Uzbekistan
Huà-să	Varsavia
Può-dò̤-ciū	Vino
Cūi	Acqua
Chà	Legno
Diêng-sê	Televisione
Chile	Cile
Ià-sŭ	Gesù
Galileo Galilei	Galileo Galilei
Cūi-sĭng	Mercurio (astronomia)
Lĭk-sṳ̄	Storia
Gĭng-sĭng	Venere (astronomia)
Ngṳ̄-ngiòng	Linguaggio
Ái	Amore
Mŭk-sĭng	Giove (astronomia)
Ngṳ̀ng-ò̤	Via Lattea
Tiĕng-uòng-sĭng	Urano (astronomia)
Hāi-uòng-sĭng	Nettuno (astronomia)
Tiĕng-ùng	Astronomia
Sĭng-gă-pŏ̤	Singapore
Kuŏ-hŏk	Scienza
Mìng-uòng-sĭng	Plutone (astronomia)
Ciŏng-lài	Futuro
Séng-mū Mā-lé-ā	Maria (madre di Gesù)
Liechtenstein	Liechtenstein
Adolf Hitler	Adolf Hitler
Dâ̤-nê-ché̤ṳ Sié-gái Dâi-ciéng	Seconda guerra mondiale
Wiki Gáu-kuŏ-cṳ̆	Wikibooks
Wiki Ngṳ̄-liŏh	Wikiquote
Wiki Dâi-hŏk	Wikiversità
Cṳ̆ng	Orologio
Ubuntu	Ubuntu
Linux	Linux
Só-hŏk	Matematica
Lá-dĭng-ngṳ̄	Lingua latina
Bahrain	Bahrein
Armenia	Armenia
Serbia	Serbia
Nguŏk-giù	Luna
Istanbul	Istanbul
Ó̤-ciŭ	Australia
Ŭk-lī	Fisica
Argentina	Argentina
Peru	Perù
Dièu-siēng Mìng-ciō-ciō-ngiê Ìng-mìng Gê̤ṳng-huò-guók	Corea del Nord
Gāng-puŏ-câi	Cambogia
Gū-làng-gĭng	Corano
Kṳ̄ng-lṳ̀ng	Dinosauria
Ĭ-sṳ̆-làng-gáu	Islam
Lì	Pyrus
Lùng-lùng	Ruota
Huò-bìng	Pace
Nṳ̄-gái	Donna
Gū-chiŏng-kĕ̤ng	Ano
Nìng-mùng	Citrus × limon
Bă-ciĕu	Banana
Huă	Fiore
Napoléon Bonaparte	Napoleone Bonaparte
Sĕng-lī	Fisiologia
Hèng-sĭng	Stella
Nĭk-tàu	Sole
Victor Hugo	Victor Hugo
Dâi-iòng-ciŭ	Oceania
Tái-iòng-hiê	Sistema solare
Ngāi	Dente
Kĭng	Idrogeno
Wiki Gê̤ṳng-hiōng	Wikimedia Commons
Cṳ̆	Libro
Nĭk	Giorno
Dĕ̤ng Timor	Timor Est
Màng-buŏ	Notte
Nièng	Anno
Ó̤-sṳ̆-lṳ̆k	Oslo
Lī-sṳ̆-buōng	Lisbona
Táng	Carbonio
Dâng	Azoto
Iōng	Ossigeno
Giàng-sĭng	Pianeta
Kleopatra 7-sié	Cleopatra VII
Ĭng-ngŏk	Musica
É-dâi-lé-ngṳ̄	Lingua italiana
Séng Peterburg	San Pietroburgo
Chad	Ciad
Lé̤ṳ	Alluminio
Sĭng-să̤-làng	Nuova Zelanda
Éng-dô	India
Tuvalu	Tuvalu
Tiék	Ferro
Tonga	Tonga
Samoa	Samoa
Solomon Gùng-dō̤	Isole Salomone
Vanuatu	Vanuatu
Papua New Guinea	Papua Nuova Guinea
William Shakespeare	William Shakespeare
Palau	Palau (stato)
Nauru	Nauru
Micronesia Lièng-băng	Stati Federati di Micronesia
Iòng (gĭng-sṳ̆k)	Piombo
Marshall Gùng-dō̤	Isole Marshall
Kiribati	Kiribati
Mūng-gū	Mongolia
Fiji	Figi
Venezuela	Venezuela
Guók-cié chiông-gì	Scacchi
Genghis Khan	Gengis Khan
Maine	Maine
Mā	Equus caballus
Ū-ké	Arma
Dông-ŭk	Animalia
Suriname	Suriname
Paraguay	Paraguay
Guyana	Guyana
Ecuador	Ecuador
Colombia	Colombia
Hŭk-gáu	Buddhismo
Bolivia	Bolivia
Dè̤ng	Rame
Trinidad gâe̤ng Tobago	Trinidad e Tobago
Sĭk-ŭk	Plantæ
Séng Vincent gâe̤ng Grenadines	Saint Vincent e Grenadine
New Hampshire	New Hampshire
Séng Lucia	Santa Lucia (Stato)
Séng Kitts gâe̤ng Nevis	Saint Kitts e Nevis
Cĭng-kṳ̄ng	Fungi
Jamaica	Giamaica
Grenada	Grenada
Massachusetts	Massachusetts
Guatemala	Guatemala
Bahamas	Bahamas
Connecticut	Connecticut
Giĕ	Gallus gallus domesticus
Antigua gâe̤ng Barbuda	Antigua e Barbuda
Hawaii	Hawaii
Honduras	Honduras
Dominica	Dominica
Dominica Gê̤ṳng-huò-guók	Repubblica Dominicana
Dṳ̆	Sus scrofa domesticus
Báe̤k-bĭng-iòng	Mar Glaciale Artico
Haiti	Haiti
El Salvador	El Salvador
Ĭ-lāng	Iran
Iraq	Iraq
Alaska	Alaska
Costa Rica	Costa Rica
Ī-sáik-liĕk	Israele
Panama	Panamá
Yemen	Yemen
Bâng-dŭk	Virus (biologia)
Pŏ̤-làng-ngṳ̄	Lingua polacca
Jordan	Giordania
Nicaragua	Nicaragua
Florida	Florida
Kyrgyzstan	Kirghizistan
Arizona	Arizona
Kuwait	Kuwait
Lō̤-kuŏ	Laos
Lebanon	Libano
Oregon	Oregon
Maldives	Maldive
Mī-ciŭ	America
Utah	Utah
Ngù	Bos taurus
Mā-lài-să̤-ā	Malesia
Miēng-diêng	Birmania
Nepal	Nepal
Oman	Oman
Pakistan	Pakistan
Qatar	Qatar
Saudi Ā-lá-báik	Arabia Saudita
Sri Lanka	Sri Lanka
Joseph Stalin	Iosif Stalin
Syria	Siria
Platon	Platone
Tajikistan	Tagikistan
Dṳ̆ng-huà Mìng-guók	Taiwan
Aristoteles	Aristotele
Tái-guók	Thailandia
Huōi-chiă	Treno
Turkmenistan	Turkmenistan
Ā-lá-báik Lièng-hăk Dâi-gŭng-guók	Emirati Arabi Uniti
Băh-gĭng	Platino
Uŏk-nàng	Vietnam
Dâi-hàng Mìng-guók	Corea del Sud
Afghanistan	Afghanistan
Gĭng	Oro
Suez Ông-ò̤	Canale di Suez
Bangladesh	Bangladesh
Mali	Mali
Sokrates	Socrate
Angola	Angola
Bhutan	Bhutan
Ùng-lài	Brunei
Tanzania	Tanzania
Cūi-ngṳ̀ng	Mercurio (elemento chimico)
Hĭ-lĭ-pĭng	Filippine
Dṳ̆ng-hĭ Gê̤ṳng-huò-guók	Repubblica Centrafricana
Isaac Newton	Isaac Newton
Albert Einstein	Albert Einstein
Uòng-sáik	Giallo
Togo	Togo
Tunisia	Tunisia
Zambia	Zambia
Zimbabwe	Zimbabwe
Báe̤k-gĭng	Pechino
Nàng Sudan	Sudan del Sud
Benin	Benin
Botswana	Botswana
Wiki Sĭng-ùng	Wikinotizie
Burkina Faso	Burkina Faso
Burundi	Burundi
Comoros	Comore
Congo Gê̤ṳng-huò-guók	Repubblica del Congo
Congo Mìng-ciō Gê̤ṳng-huò-guók	Repubblica Democratica del Congo
Djibouti	Gibuti
Chiáh-dô̤ Guinea	Guinea Equatoriale
Eritrea	Eritrea
Gabon	Gabon
Gambia	Gambia
Guinea	Guinea
Guinea-Bissau	Guinea-Bissau
Côte d'Ivoire	Costa d'Avorio
Cameroon	Camerun
Cabo Verde	Capo Verde
Lesotho	Lesotho
Liberia	Liberia
Libya	Libia
Madagascar	Madagascar
Malawi	Malawi
Mauritania	Mauritania
Mauritius	Mauritius
Morocco	Marocco
Mozambique	Mozambico
Namibia	Namibia
Niger	Niger
Nigeria	Nigeria
Charles Darwin	Charles Darwin
Uganda	Uganda
Rwanda	Ruanda
Séng Tomé gâe̤ng Príncipe	São Tomé e Príncipe
Senegal	Senegal
Seychelles	Seychelles
Carl Linnaeus	Linneo
Sierra Leone	Sierra Leone
Somalia	Somalia
Julius Caesar	Gaio Giulio Cesare
Sudan	Sudan
Swaziland	Swaziland
Kê̤ṳng	Arcobaleno
Lièng-hăk-guók	Organizzazione delle Nazioni Unite
Dê-cék	Geologia
Dê-lī	Geografia
Sĭng-câung	Cuore umano
Puòi-hŭ	Pelle
Ngàng-sáik	Colore
Làng-sáik	Blu
Ngṳ̀ng	Argento
Sék	Stagno (elemento chimico)
Michigan	Michigan
Illinois	Illinois
North Dakota	Dakota del Nord
South Dakota	Dakota del Sud
Montana	Montana
Wyoming	Wyoming
Idaho	Idaho
Washington	Washington (stato)
Nevada	Nevada
Éng-dô-iòng	Oceano Indiano
Kosovo	Kosovo
Colorado	Colorado
分類:Hŭng-lôi	Categoria:Categorie
Chicago	Chicago
Dĕ̤ng-tiĕng	Inverno
Chŭng-tiĕng	Primavera
Hâ-tiĕng	Estate
Chiŭ-tiĕng	Autunno
Saddam Hussein	Saddam Hussein
Osama bin Laden	Osama bin Laden
Să̤-băng-ngà-ngṳ̄	Lingua spagnola
Philadelphia	Filadelfia (Stati Uniti d'America)
Tĭ-tṳ̆	Araneae
Guō-sĭk	Frutto
Cièng	Denaro
Virginia	Virginia
West Virginia	Virginia Occidentale
Huăng-ciĕu	Capsicum annuum
Niū-iók-ciŭ	New York (Stato)
Rhode Island	Rhode Island
Kŏng-tṳ̀ng	Insecta
Maryland	Maryland
Delaware	Delaware
Vladimir Lenin	Lenin
Ohio	Ohio
Pennsylvania	Pennsylvania
Augustus	Augusto
Microsoft Windows	Microsoft Windows
New Jersey	New Jersey
Hŭng-làng-ngṳ̄	Lingua finlandese
Indiana	Indiana
Ké-chiă	Autovettura
Georgia	Georgia (Stati Uniti d'America)
Texas	Texas
North Carolina	Carolina del Nord
South Carolina	Carolina del Sud
Manila	Manila
Dĕ̤ng-gĭng	Tokyo
Uòng-lì	Ananas comosus
Mississippi	Mississippi
Tennessee	Tennessee
New Mexico	Nuovo Messico
Ngà-diēng	Atene
Minnesota	Minnesota
Baghdad	Baghdad
Wisconsin	Wisconsin
Iowa	Iowa
Nebraska	Nebraska
Kansas	Kansas
Hŏng-giāng	Sigaretta
Missouri	Missouri
Louisiana	Louisiana
Kentucky	Kentucky
Arkansas	Arkansas
Oklahoma	Oklahoma
Madonna	Madonna (cantante)
Aceh	Aceh
Séng-gĭng	Bibbia
Phnom Penh	Phnom Penh
Hù Cé-mìng Chê	Ho Chi Minh (città)
Ò̤-nô̤i	Hanoi
Cĭng Ià-sŭ Gáu-huôi	Vera Chiesa di Gesù
Ĭng-ngṳ̄	Lingua inglese
Màng-gók	Bangkok
Kuala Lumpur	Kuala Lumpur
Bangka Belitung Gùng-dō̤	Bangka-Belitung
Dài-báe̤k	Taipei
Concepción	Concepción (Cile)
Bengkulu	Bengkulu
Końskowola	Końskowola
Nê-iōng-huá-táng	Anidride carbonica
Jambi	Jambi
Siè	Serpentes
Lampung	Lampung
Guŏng-sók	Velocità della luce
Riau	Riau
Riau Gùng-dō̤	Isole Riau
Nàng Sumatra	Sumatra Meridionale
Lò̤-mā Dá̤-guók	Impero romano
Mì-niōng	Microsoft
Kó-lū-hŭ	Kurów
Huá-hŏk	Chimica
Sièng-sŏng	Acido cloridrico
Ôi-sĭng	Satellite naturale
Kă-giù	Calcio (sport)
Să̤ Sumatra	Sumatra Occidentale
Mā-dáik-lī	Madrid
Michael Jackson	Michael Jackson
Cê̤ṳ-iù	Libertà
Sék-nà̤	Sydney
Liŏh-sáik	Verde
È̤ng-sáik	Rosso
Huōi	Fuoco
Sĭng Nàng Wales	Nuovo Galles del Sud
Nile Ò̤	Nilo
Banten	Banten
Dṳ̆ng Jawa	Giava Centrale
Chēng-chiū-sĭng	Cometa
Dĕ̤ng Jawa	Giava Orientale
Jakarta	Giacarta
Ăng-kā-lá	Ankara
Să̤ Jawa	Giava Occidentale
Yogyakarta	Yogyakarta
Dṳ̆ng Kalimantan	Kalimantan Centrale
Dĕ̤ng Kalimantan	Kalimantan Orientale
Báe̤k Kalimantan	Kalimantan Settentrionale
Nàng Kalimantan	Kalimantan Meridionale
Hŏk-hâu	Scuola
Să̤ Kalimantan	Kalimantan Occidentale
Dâi-hŏk	Università
Wikipedia:Să-buàng	Wikipedia:Pagina delle prove
Chió	Casa
Dê-dù	Mappa
Ò̤	Fiume
Osasco	Osasco (San Paolo)
Chiĕng-lī-giáng	Telescopio
分類:Dài-uăng lĭk-sṳ̄	Categoria:Storia di Taiwan
Curitiba	Curitiba
Sĕng-lìng	Foresta
分類:Uŏk-nàng lĭk-sṳ̄	Categoria:Storia del Vietnam
Iók-báik-cṳ̆	Libro di Giobbe
Cĭng-ngiòng	Libro dei Proverbi
Kūng-cṳ̄	Confucio
Hà	Decapoda
分類:Só-hŏk	Categoria:Matematica
Bali	Bali
Ĕu-nguòng	Euro
Mī-gĭng	Dollaro statunitense
Dâi-lièu	Dinastia Liao
Hòng-ciŭ	Hangzhou
Gĭ-dók-gáu	Cristianesimo
Dĕ̤ng Nusa Tenggara	Nusa Tenggara Orientale
Să̤ Nusa Tenggara	Nusa Tenggara Occidentale
Dṳ̆ng Sulawesi	Sulawesi Centrale
Gĭng-guók	Dinastia Jīn
Gorontalo	Provincia di Gorontalo
Báe̤k Sulawesi	Sulawesi Settentrionale
Dĕ̤ng-nàng Sulawesi	Sulawesi Sudorientale
Nàng Sulawesi	Sulawesi Meridionale
Să̤ Sulawesi	Sulawesi Occidentale
Seattle	Seattle
Maluku	Provincia di Maluku
Báe̤k Maluku	Maluku Settentrionale
Papua	Papua (provincia indonesiana)
Să̤ Papua	Papua Occidentale
Cēu	Aves
Siū-dŭ	Capitale (città)
Può-dò̤-ngà-ngṳ̄	Lingua portoghese
Nguŏk	Mese
Uòng Hiêng-huàng	Huang Xianfan
Cōng	Diamante
Nĭk-buōng-ngṳ̄	Lingua giapponese
Báik-kuŏ-ciòng-cṳ̆	Enciclopedia
Tàu Hiĕk	Pagina principale
模板:Ô-lī-kó̤	Template:Voce di qualità
Saratov	Saratov
Làng-giù	Pallacanestro
Olympic Ông-dông-huôi	Giochi olimpici
Diòng-gĕ̤ng	Fiume Azzurro
Che Guevara	Che Guevara
Mò̤ Dĕk-dŭng	Mao Tse-tung
Să̤-ăng	Xi'an
Lá-sák	Lhasa
Séng-gău	Rapporto sessuale
Ĭng-dô̤	Vagina
Diék-hŏk	Filosofia
分類:Ché̤ṳk-káik chēng-dṳ̀	Categoria:Cancellare subito
Gáung-kìng	Pianoforte
Dà	Tè
Marco Polo	Marco Polo
Hebe Camargo	Hebe Camargo
Gê̤ṳng-sāng-ciō-ngiê	Comunismo
Cṳ̆-buōng-ciō-ngiê	Capitalismo
Guók-gă	Paese (area geografica)
Mìng-cŭk	Nazione
Carthago	Cartagine
Uōng-hiĕk liù-lāng-ké	Browser
Siù-cūi	Nuoto
分類:Tiĕng-ùng	Categoria:Astronomia
Hŭk	Buddha
Lī Bĕk	Li Bai
Dù-cṳ̆-guāng	Biblioteca
Sĕng-tái	Ecologia
Céng-dê	Politica
Mìng-ciō	Democrazia
Cìng-dièu	Dinastia Qin
Nobel Ciōng	Premio Nobel
Cìng Sṳ̄-huòng	Qin Shi Huang
Dṳ̆ng-dĕ̤ng	Medio Oriente
Háng-dièu	Dinastia Han
Làu Băng	Gao Zu (imperatore Han)
Háng Gīng-dá̤	Jingdi
Háng Ū-dá̤	Han Wudi
Sĕng-ŭk	Organismo vivente
Rabindranath Tagore	Rabindranath Tagore
Háng Guŏng-ū-dá̤	Liu Xiu
Gŭng-ciō-cié-dô	Monarchia
Siâ-huôi-ciō-ngiê	Socialismo
Cṳ̆ng-chói	Bacio
Nguòng-dièu	Dinastia Yuan
Nazi Dáik-guók	Germania nazista
Christopher Columbus	Cristoforo Colombo
Dâng Huò	Zheng He
Panama Ông-ò̤	Canale di Panama
Céng-dièu	Dinastia Jìn
Nàng-bĭng-iòng	Oceano antartico
Uòng-ò̤	Fiume Giallo
Sṳ̆-mā Ièng	Wu Di (imperatore Jin)
Ngê	Orecchio
Pé	Naso
Mĕ̤k-ciŭ	Occhio
Hŭng-muòng	Culicidae
Săi-ngṳ̀	Selachimorpha
Lŏk-dò̤	Camelus
Mā-ngiê	Formicidae
Sùi-dièu	Dinastia Sui
Hò̤-làng-ngṳ̄	Lingua olandese
Sùi Ùng-dá̤	Sui Wendi
Sùi Iòng-dá̤	Sui Yangdi
Să̤-hâ	Dinastia Xia occidentale
Sóng-dièu	Dinastia Song
Sóng Tái-cŭng	Song Tai Zong
Sóng Cĭng-cŭng	Song Zhenzong
Sóng Ìng-cŭng	Song Renzong
Sóng Hŭi-cŭng	Hui Zong (imperatore Song)
Ögedei	Ögödei
Güyük	Güyük
Möngke	Munke
Kublai	Kublai Khan
Huă-chái	Brassica oleracea var. botrytis
Giò (sĭk-ŭk)	Solanum melongena
Siók	Neve
Niè-giāng	Bambino
Cā-tàu	Mattino
Hŭng-cṳ̆ng	Minuto
Ngò̤-lò̤-sṳ̆-ngṳ̄	Lingua russa
Huák-lŭk	Diritto
Hièng-huák	Costituzione
Háng-ngṳ̄	Lingua cinese
Sá̤-bàu	Cellula
Háik	Sangue
Hié (ké-guăng)	Polmone
Romania-ngṳ̄	Lingua romena
Bulgaria-ngṳ̄	Lingua bulgara
Ṳ̄	Pioggia
Dê-cīng	Terremoto
Cūi-căi	Inondazione
Hāi-lâung	Maremoto
Hùng	Nuvola
Hŭng-tăi	Ciclone tropicale
Hŭng	Vento
Georgia-ngṳ̄	Lingua georgiana
Háng-cê	Carattere cinese
Dièu-siēng-cê	Hangŭl
Lá-dĭng cê-mō̤	Alfabeto latino
Ùng-hŏk	Letteratura
分類:Ĭng-ngŏk	Categoria:Musica
分類:Ùng-hŏk	Categoria:Letteratura
È̤ng-làu-máe̤ng	Il sogno della camera rossa
Hù-lì	Volpe
Harry Potter	Harry Potter
Chiū-ìng	Masturbazione
Siâ-huôi	Società (sociologia)
Gáu-ṳ̆k	Educazione
Nàng-gái	Uomo (genere)
Ìng-guòng	Diritti umani
Temür	Temür Khan
Gŭng-sê̤ṳ	Militare
Gă-pĭ	Caffè
Săng	Montagna
Khayisan	Külüg Khan
Ayurbarwada	Buyantu Khan
Shidibala	Gegeen Khan
Yesün Temür	Yesün Temür Khan
Sŏng Dṳ̆ng-săng	Sun Yat-sen
Hiŏng-gē̤ng	Hong Kong
Miami	Miami
Ragibagh	Ragibagh Khan
Tugh Temür	Jayaatu Khan
Kuśala	Khutughtu Khan
Hàng Ciéng	Guerra di Corea
Rinchinbal	Rinchinbal Khan
Toghon Temür	Hui Zong
Siū-ék	Seul
Siông-hāi	Shanghai
Ùng-huá Dâi-gáik-mêng	Grande rivoluzione culturale
Chĭng-dièu	Dinastia Qing
Uŏk-nàng Ciéng-cĕng	Guerra del Vietnam
Thomas Edison	Thomas Edison
Armenia-ngṳ̄	Lingua armena
Ukraine-ngṳ̄	Lingua ucraina
HTML	HTML
Steven Spielberg	Steven Spielberg
Mŏ̤h-ngiòng	Mo Yan
Sôi-diēng-ngṳ̄	Lingua svedese
Dăng-măk-ngṳ̄	Lingua danese
Nò̤-ŭi-ngṳ̄	Lingua norvegese
Luxembourg-ngṳ̄	Lingua lussemburghese
Ciék-káik-ngṳ̄	Lingua ceca
Karl Marx	Karl Marx
Nĕng-nĕng	Mammella
Guŏng	Luce
Hĭ-lé-nà̤-ngṳ̄	Lingua greca
Ái-ī-làng-ngṳ̄	Lingua irlandese
Kié-ngò̤	Spheniscidae
Pŏ̤-sṳ̆-ngṳ̄	Lingua persiana
Cŭng-gáu	Religione
Hàng-guók-ngṳ̄	Lingua coreana
Cháung-sié-gé	Genesi
Chók-Ăi-gĭk-gé	Libro dell'Esodo
Háng-ngṳ̄ Guăng-uâ	Lingua cinese mandarino
Uŏk-nàng-ngṳ̄	Lingua vietnamita
Sigmund Freud	Sigmund Freud
Tái-guók-ngṳ̄	Lingua thailandese
Mā-lài-ngṳ̄	Lingua malese
Mūng-gū-ngṳ̄	Lingua mongola
Bandar Seri Begawan	Bandar Seri Begawan
Hĭ-báik-lài-ngṳ̄	Lingua ebraica
Ŭi-ī-sê̤ṳ-ngṳ̄	Lingua gallese
Sŭ-gáik-làng-ngṳ̄	Lingua gaelica scozzese
Vientiane	Vientiane
Lō̤-cṳ̄	Laozi
Găng-câung	Fegato
Sṳ̆-mā Chiĕng	Sima Qian
Tó	Coniglio
Ciŏ Hĭ	Zhu Xi
Cìng-gāng	Emozione
Dâi-iòng	Oceano
Victoria Nṳ̄-uòng	Vittoria del Regno Unito
Sék-giă-mèu-nà̤	Gautama Buddha
Mŭk-hâng-mĕk-dáik	Maometto
Hŭ-ngék	Respirazione
Ṳ̀-gă	Confucianesimo
Bók-lō̤	Addome
Dô̤-gáu	Taoismo
Chói-siĕk	Lingua (anatomia)
Dâiu-gáuk	Collo
Chói	Bocca
Elizabeth 2-sié	Elisabetta II del Regno Unito
Dòng-dièu	Dinastia Tang
Dòng Gŏ̤-cū	Gao Zu
Dòng Tái-cŭng	Tai Zong (imperatore Tang)
Dòng Gŏ̤-cŭng	Gao Zong
Dòng Dṳ̆ng-cŭng	Zhong Zong
Dòng Iô-cŭng	Rui Zong
Ū Cáik-tiĕng	Imperatrice Wu
Dòng Hièng-cŭng	Xuan Zong
Dòng Sé̤ṳk-cŭng	Su Zong (imperatore Tang)
Dòng Dâi-cŭng	Dai Zong
Dòng Dáik-cŭng	De Zong
Siēu-hŏk	Scuola primaria
Mìng-dièu	Dinastia Ming
Ciŏ Nguòng-ciŏng	Zhu Yuanzhang
Ronald Reagan	Ronald Reagan
Gióng-ùng Huòng-dá̤	Jianwen
Īng-lŏk Huòng-dá̤	Yongle
Hùng-hĭ Huòng-dá̤	Hongxi
Sŏng-dáik Huòng-dá̤	Xuande
Mìng Ĭng-cŭng	Zhengtong
Gīng-tái Huòng-dá̤	Jingtai
Sìng-huá Huòng-dá̤	Chenghua
Hùng-dé Huòng-dá̤	Hongzhi
Céng-dáik Huòng-dá̤	Zhengde
Gă-cêng Huòng-dá̤	Jiajing
Lè̤ng-kéng Huòng-dá̤	Longqing
Uâng-lĭk Huòng-dá̤	Wanli
Tái-chiŏng Huòng-dá̤	Taichang
Tiĕng-kiē Huòng-dá̤	Tianqi
Sùng-dĭng Huòng-dá̤	Chongzhen
Gĭng Céng-nĭk	Kim Jong-il
Nguòng-só ciŭ-gĭ-biēu	Tavola periodica degli elementi
Chăng-màng	Cecità
Sá̤-kṳ̄ng	Bacteria
Chéu	Albero
Può-dò̤	Uva
Huăng-giāng-sṳ̀	Solanum tuberosum
Uòng-dâu	Glycine max
Séng-sék	Informazione
Bó̤-cāi	Giornale
Diêng-uâ	Telefono
Ùng-huá	Cultura
Huáng-ngṳ̄	Lingua sanscrita
Dâi-diòng	Intestino crasso
Siēu-diòng	Intestino tenue
Ĭ-hŏk	Medicina
Huá-hŏk nguòng-só	Elemento chimico
Unix	Unix
Ùi-gì	Go (gioco)
Káh-dièu-nó̤h	Giocattolo
Diêng-īng	Film
Gĭng-sṳ̆k	Metallo
Kă-dăk-chiă	Bicicletta
Mièng-huă	Cotone (fibra)
Sók-dô	Velocità
Sì-găng	Tempo
Cāi	Carta
Só-lâiu	Materie plastiche
Miêng-cék	Area
Gŭng-chióh	Metro
Iù-diĕng-bău	Zea mays
Duâi-măk	Hordeum vulgare
Dĕ̤ng-nàng-ā	Sud-est asiatico
Sīng-iòng	Shenyang
Tṳ̀ng-kéng	Chongqing
Tiĕng-cĭng	Tientsin
Ū-háng	Wuhan
Gū Ăi-gĭk	Antico Egitto
Gū Hĭ-lé-nà̤	Antica Grecia
Hṳ̀ng	Ursidae
Britney Spears	Britney Spears
Măk	Triticum
Cié-sē̤	Sorghum
Pó̤-sióng	Disabilità
Lĭk-huák	Calendario
Sìng-gĭng-bâng	Disturbo mentale
Gregorius Lĭk-huák	Calendario gregoriano
Tutankhamun	Tutankhamon
Nguŏk-gĭng	Mestruazione
Mà-chiók	Mah Jong
Ông-ò̤	Canale artificiale
Detroit	Detroit
Diòng-siàng	Grande muraglia cinese
Gĭng-cê-ták	Piramide
Osman Dá̤-guók	Impero ottomano
Guók-nô̤i sĕng-sāng cūng-dĭk	Prodotto interno lordo
Diêng	Elettricità
Ché̤ṳng	Arma da fuoco
Lòng-gĭ-ché̤ṳng	Mitragliatrice
Sáung-buàng	Abaco
Tāng-káik	Carro armato
Chāu-muòi	Fragola
Liĕk-chiĕ	Litchi chinensis
Ià-cī	Cocos nucifera
Tò̤	Prunus persica
Cáung-ngṳ̄	Lingua zhuang
Siŏng-ngṳ̄	Lingua xiang
Mì-ngù-ī-ngṳ̄	Lingua uigura
Wiki Ŭk-cṳ̄ng	Wikispecies
Nĕng-dáe̤k	Reggiseno
Ā-lá-báik-ngṳ̄	Lingua araba
Cūng-lī	Primo ministro
Lù Ū-hièng	Roh Moo-hyun
Páuk Céng-hĭ	Park Chung-hee
Siĕng-ìng-ciōng	Cactaceae
Iòng-bék	Matita
Gă-sĭ	Arredamento
Dó̤h	Tavolo
Ó̤-muòng	Macao
Liòng Cīng-ĭng	Leung Chun-ying
Iē-giāng	Sedia
Hù Gīng-dò̤	Hu Jintao
Sĭk Gê̤ṳng-bìng	Xi Jinping
Dòng-gêng-lĕ̤k	Giraffa camelopardalis
Chĭng-dáung	Shenzhen
Guōng-dĕ̤ng	Guangdong
Guōng-să̤	Guangxi
Sŭ-lièng	Unione Sovietica
Kiák-sióng-gĭ	Fotocamera
Kagoshima-gâing	Prefettura di Kagoshima
C ngṳ̄-ngiòng	C (linguaggio)
Kă	Piede
Ciēng	Gekkonidae
Dô-dâing	Lacertilia
Giĕng-tàu	Spalla
Wikipedia:Bō̤-ciéng hō̤ ùng	Wikipedia:Vetrina
模板:Link FA	Template:Link V
Sié-gái	Mondo
Wikipedia:Duâi chéu â	Wikipedia:Bar
Busan	Pusan
Lèng-huă	Nelumbo nucifera
Vermont	Vermont
Denver	Denver
Guōng-ciŭ	Canton
Ciōng Gái-sĭk	Chiang Kai-shek
Gŏng Dĕk-mìng	Jiang Zemin
Ŭng Gă-bō̤	Wen Jiabao
Nàng-gĭng	Nanchino
Làu Dáik-huà	Andy Lau
Diŏng Hŏk-iū	Jacky Cheung
Báe̤k-gĭng Dâi-hŏk	Università di Pechino
Chĭng-huà Dâi-hŏk	Università Tsinghua
Ŭ-lū-mŭk-cà̤	Ürümqi
Gŏng-sŭ	Jiangsu
Ciék-gŏng	Zhejiang
Dâing Siēu-bìng	Deng Xiaoping
Lò̤-mā Gê̤ṳng-huò-guók	Repubblica romana
Câung-kṳ̆	Tibet
Să̤-câung	Regione Autonoma del Tibet
Ciŭ Ŏng-lài	Zhou Enlai
Dṳ̆ng-guók Gê̤ṳng-sāng-dōng	Partito Comunista Cinese
Chiū-gĭ	Telefono cellulare
Dò̤-nēu	Struthio camelus
Kŏng-hĭ Huòng-dá̤	Kangxi
Dièu-siēng	Corea
Lī Káik-giòng	Li Keqiang
Gŏ̤ Hèng-giông	Gao Xingjian
Lī Bèng	Li Peng
Lòng	Canis lupus
Bìng-iōng	Pyongyang
Sĭng-iók Séng-gĭng	Nuovo Testamento
9	9 (numero)
Kiék	Scorpiones
Gièng-lè̤ng Huòng-dá̤	Qianlong
Dṳ̆ng-guók Dâi-lṳ̆k	Cina continentale
Háik-lṳ̀ng-gĕ̤ng-sēng	Heilongjiang
Mā Ĭng-gāu	Ma Ying-jeou
Lè̤	Equus asinus
Wikipedia:Cék-liông ô-lī-kó̤ gì ùng-ciŏng	Wikipedia:Voci di qualità
Sé-chiŏng	Sichuan
Gô-iók Séng-gĭng	Antico Testamento
Séng-dáng-cáik	Natale
Săng-gáe̤k-hìng	Triangolo
Muammar Gaddafi	Mu'ammar Gheddafi
Lâu-hū	Panthera tigris
Daejeon	Daejeon
Daegu	Taegu
Sié-cŭng Dĕk-biék Cê̤ṳ-dé-chê	Città di Sejong
Incheon	Incheon
Gyeonggi Dô̤	Gyeonggi
Bô-uăk-cáik	Pasqua
Ò̤-báe̤k	Hebei
Bŏk Hĭ-lài	Bo Xilai
GNU Cê̤ṳ-iù Ùng-dáung Hṳ̄-kō̤-céng	GNU Free Documentation License
Uŏng Cĭng-ôi	Wang Jingwei
Dìng Cūi-biēng	Chen Shui-bian
Dài-uăng	Isola di Formosa
À̤	Scarpa
Ngṳ̀ng-hòng	Banca
Lū Séng	Lu Xun
7	7 (numero)
8	8 (numero)
Lĕ̤k	Cervidae
Hù	Lago
Sáung-tàu	Allium sativum
Chái-guă	Cucumis sativus
Dō̤	Isola
Băh-sáik	Bianco
Ŭ-sáik	Nero
6	6 (numero)
Moshchena	Moščena
Huăng-kê	Solanum lycopersicum
George H. W. Bush	George H. W. Bush
Quảng Bình	Provincia di Quang Binh
Atlanta	Atlanta
Benito Mussolini	Benito Mussolini
Sṳ̀-diēng	Dizionario
Tàu	Testa
Hiê-lìng-dóng	Wellington
Dâi Bók-liĕk-diĕng Dō̤	Gran Bretagna
Las Vegas	Las Vegas
10	10 (numero)
Alfred Nobel	Alfred Nobel
Tàu-sĕ̤	Pettine
Guòng-lĭk	Potere
Mà-hùng-cēu	Strigiformes
Dēng-cṳ̆ng	Ora
Ké-chiông	Meteorologia
Đà Nẵng	Da Nang
Káh-chiók	Pica pica
Làng-huă	Orchidaceae
Gă-săk	Blattodea
Ngáuk-ngṳ̀	Crocodylia
Lā-lì	Manis
Nàng-muōi-sĭng	Lampyridae
Holocene	Olocene
Hāi-báu	Phocidae
Bà̤-bá-cēu	Troglodytes troglodytes
Ciáh-giāng	Passer montanus
Niccolò Cusano Dâi-hŏk	Università degli Studi @@@u0026Niccolò Cusano"
Long An	Provincia di Long An
Thái Nguyên	Provincia di Thai Nguyen
Herodotus	Erodoto
Othello	Otello
Nĭk-buōng-hāi	Mar del Giappone
Dĕ̤ng-ā	Asia orientale
Dĕ̤ng-ĕu	Europa orientale
Vĩnh Phúc	Provincia di Vinh Phuc
Chĕ̤ng	Allium fistulosum
Liù-giù-guók	Regno delle Ryūkyū
Dièu-siēng uòng-dièu	Dinastia Joseon
Gŏ̤-là̤	Goryeo
Dâi-hàng Dá̤-guók	Impero coreano
Buŏk-hāi-guók	Balhae
Gŏ̤-gău-là̤	Koguryŏ
Bì-bà-dâu-giék	Chiroptera
Báik-cá̤	Paekje
Sĭng-lò̤	Regno di Silla
Tàu-huók	Pelo
Hàng Hĭ	Han Fei
Uòng-dá̤	Huang Di
Diéu-ngṳ̀-dài Liĕk-dō̤	Isole Senkaku
Gê̤ṳng-huò-dōng (Mī-guók)	Partito Repubblicano (Stati Uniti d'America)
Mìng-ciō-dōng (Mī-guók)	Partito Democratico (Stati Uniti d'America)
Cūi-tiák	Lutra lutra
Sìng-dŭ	Chengdu
Buò-gŭng-ĭng	Taraxacum
Tá	Medusa (zoologia)
Dâng-ciŭ	Zhengzhou
Cūng-tūng	Presidente
Muāng-ciŭ-guók	Manciukuò
Gù-cŭi	Streptopelia
Só̤h	Corda
Dṳ̆ng-guók Guók-mìng-dōng	Kuomintang
Ngâng	Anser cygnoides
Ĕng-gŏ̤	Psittaciformes
Gă-huák	Addizione
Dài-uăng-sēng	Provincia di Taiwan
Dŏ̤	Coltello
Băng-mā	Zebra
Guók-cié biĕu-cūng cṳ̆-hô̤	ISBN
Đồng Nai	Provincia di Dong Nai
Sóc Trăng	Provincia di Soc Trang
Quảng Ngãi	Provincia di Quang Ngai
Hà Tĩnh	Provincia di Ha Tinh
Cà Mau	Provincia di Cà Mau
Quảng Nam	Provincia di Quang Nam
Bến Tre	Provincia di Ben Tre
Khánh Hòa	Provincia di Khanh Hoa
Káh-gă-ngṳ̄	Lingua hakka
Sơn La	Provincia di Son La
Huŏng-ngiòng	Dialetto
Lev Trotsky	Lev Trockij
Quảng Ninh	Provincia di Quang Ninh
Lạng Sơn	Provincia di Lang Son
Bắc Ninh	Provincia di Bac Ninh
Gáng-ngṳ̄	Lingua gan
Sṳ̆-mā Guŏng	Sima Guang
Mà-hṳ̀ng	Ailuropoda melanoleuca
Muāng-ngṳ̄	Lingua mancese
Chiū	Mano
Dô Hū	Du Fu
Gùng-dō̤	Arcipelago
Niŏh-niŏh	Foglia
Bŭk-buó	Cascata
Yasser Arafat	Yasser Arafat
Chṳ̆ng-sìng-ngṳ̄	Lingua di Okinawa
Câung-ngṳ̄	Lingua tibetana
Ngù-ngṳ̄	Lingua wu
Tasmania	Tasmania
Ì-cô̤	Sapone
Hŭk-săng	Foshan
Ciĕu-huò Tiĕng-huòng	Hirohito
Al-Qaeda	Al-Qaida
Mò̤-táuk-chiă	Motocicletta
Ò̤-mā	Hippopotamus amphibius
Anastacia	Anastacia
Sĕk Gái	Dieci comandamenti
Huă-báu	Panthera pardus
Să̤-ngiù	Rhinocerotidae
Lò̤-buàng	Bussola
Buáng-dō̤	Penisola
Sĭng-giŏng	Xinjiang
Mŭk-guă	Carica papaya
Mì-sĕng-só	Vitamine
Gái-làng-chái	Brassica oleracea var. capitata
Giáng	Specchio
Ciŭ-dièu	Dinastia Zhou
Kāng-muòng-giāng	Finestra
Băh Gṳ̆ng	Casa Bianca
Gīng-chák	Polizia
Báe̤k-hāi-dô̤	Hokkaidō
Giŏng	Zingiber officinale
Nobel Huò-bìng Ciōng	Premio Nobel per la pace
Sáu	Tosse
Hák-chê	Starnuto
Káung-mìng	Sonno
Gèng-hāi	Lago d'Aral
Dé̤ṳk	Bambuseae
Hù Cé-mìng	Ho Chi Minh
Hòa Bình	Provincia di Hoa Binh
Sŭ Sék	Su Shi
Queensland	Queensland
Tù	Suolo
Ù-huă-guō	Ficus carica
Hưng Yên	Provincia di Hung Yen
Dòng-dô	Lunghezza
Kon Tum	Provincia di Kon Tum
Hậu Giang	Provincia di Hau Giang
Máe̤ng	Sogno
Yên Bái	Provincia di Yen Bai
Bắc Giang	Provincia di Bac Giang
Thừa Thiên-Huế	Provincia di Thua Thien-Hue
Bắc Kạn	Provincia di Bac Kan
Lai Châu	Provincia di Lai Chau
Hà Nam	Provincia di Ha Nam
Lào Cai	Provincia di Lao Cai
Mìng-dĕ̤ng-ngṳ̄	Min dong
Hannibal	Annibale
Mìng-nàng-ngṳ̄	Lingua min nan
Thanh Hóa	Provincia di Thanh Hoa
Kiên Giang	Provincia di Kien Giang
Quảng Trị	Provincia di Quang Tri
Nghệ An	Provincia di Nghe An
An Giang	Provincia di An Giang
Tây Ninh	Provincia di Tay Ninh
Phú Thọ	Provincia di Phu Tho
Duâi-sĭng-sĭng	Gorilla
Trà Vinh	Provincia di Tra Vinh
Bạc Liêu	Provincia di Bac Lieu
Gia Lai	Provincia di Gia Lai
Tiền Giang	Provincia di Tien Giang
Bình Phước	Provincia di Binh Phuoc
Đồng Tháp	Provincia di Dong Thap
Thái Bình	Provincia di Thai Binh
Hà Giang	Provincia di Ha Giang
Đắk Lắk	Provincia di Dak Lak
Cáung-cŭk	Zhuang
Bình Định	Provincia di Binh Dinh
Lâm Đồng	Provincia di Lam Dong
Đắk Nông	Provincia di Dak Nong
Phú Yên	Provincia di Phu Yen
Hải Dương	Provincia di Hai Duong
Dièu-ciŭ-uâ	Dialetto teochew
Iók-hâng Hók Ĭng	Vangelo secondo Giovanni
Dài-uăng-uâ	Lingua taiwanese
Muòng	Porta
Chiēng-gák	Unghia
Cao Bằng	Provincia di Cao Bang
Bình Dương	Provincia di Binh Duong
Bình Thuận	Provincia di Binh Thuan
Bà Rịa-Vũng Tàu	Provincia di Ba Ria-Vung Tau
Ninh Bình	Provincia di Ninh Binh
Ninh Thuận	Provincia di Ninh Thuan
Nam Định	Provincia di Nam Dinh
Điện Biên	Provincia di Dien Bien
Sìng-lṳ̀ng	Jackie Chan
Méng	Viso
Gāng-lāng	Olea europaea
Săng-ôi-ék-tā̤	Trinità (cristianesimo)
Sŏng-cṳ̄	Sun Tzu
Sĭng-săng	Docente
Cleveland	Cleveland
Dăk-lâi Lā-mà	Dalai Lama
Huă-sĕng	Arachis hypogaea
100	100 (numero)
Kă-kók-tàu	Ginocchio
Hâing	Prunus armeniaca
Ngāng-giáng	Occhiali
Cê̤ṳ-lài-huōi	Fiammifero
Chê-diòng	Mercato
Nàng Dṳ̆ng-guók Hāi	Mar Cinese Meridionale
Dièu-siēng Sié-cŭng	Sejong il Grande
Hăk-gĭng	Lega (metallurgia)
Bĭng-siŏng	Frigorifero
Nobel Ùng-hŏk Ciōng	Premio Nobel per la letteratura
Huăng-sṳ̀	Ipomoea batatas
Uòng-hāi	Mar Giallo
Akihito	Akihito
Newton ông-dông-hŏk dêng-lŭk	Principi della dinamica
Să̤-guă	Citrullus lanatus
Biobío Dâi-hŏk	Università del Bío-Bío
Huòng-dá̤	Imperatore
Ìng-mìng-bê	Renminbi cinese
Tā̤-cék	Volume
Cèng-sáik	Arancione
Gă-sĭ-huă	Attrezzo
Ĭ-sĕng	Medico
Iéng (cēu)	Hirundinidae
Kó	Pantaloni
Lô-gă Hók Ĭng	Vangelo secondo Luca
Mìng-ciō-dōng	Partito Democratico (disambigua)
Ciŏng-tàu	Mattone
Tiō-uòng	Ellisse
Sìng-huák	Moltiplicazione
Sé̤ṳ-dù Hèng-diông	Atti degli Apostoli
Uòng-dô̤ Sĕk-nê Sĭng-cô̤	Zodiaco
Huá-siŏh	Fossile
Gēng-huák	Sottrazione
Cī-cī	Seme
Chiĕk	Brachyura
Gă-dŏ̤	Forbici
Niêu	Urina
Ăng-hŭi	Anhui
Ngiăh	Fronte (anatomia)
Sĭ-piĕng	Salmi
Chungcheong Báe̤k-dô̤	Chungcheong Settentrionale
Chungcheong Nàng-dô̤	Chungcheong Meridionale
Gangwon Dô̤ (Dâi-hàng Mìng-guók)	Gangwon
Nô̤i Mūng-gū	Mongolia Interna
Gĭng Nĭk-sìng	Kim Il-sung
Gyeongsang Nàng-dô̤	Gyeongsang Meridionale
Gyeongsang Báe̤k-dô̤	Gyeongsang Settentrionale
Jeolla Báe̤k-dô̤	Jeolla Settentrionale
Jeolla Nàng-dô̤	Jeolla Meridionale
Jeju Dĕk-biék Cê̤ṳ-dé-dô̤	Jeju-do
Huăng-cièng-giāng	Moneta
Bă-biĕk-ták	Torre di Babele
Ulsan	Ulsan
Gwangju	Gwangju
Chó	Aceto
Kangwŏn Dô̤ (Dièu-siēng Mìng-ciō-ciō-ngiê Ìng-mìng Gê̤ṳng-huò-guók)	Kangwon
Michael Jordan	Michael Jordan
Lé-ê-gé	Levitico
Gṳ̆ng-gṳ̆ng	Radice (botanica)
Bì-bà (cūi-guō)	Eriobotrya japonica
Hamlet	Amleto
Huà Guók-hŭng	Hua Guofeng
Sāng	Ombrello
Làu Hiēu-pŏ̤	Liu Xiaobo
Hók-gióng	Fujian
Mūng-gū-cŭk	Mongoli
Mĕk-sê Liŏh	Apocalisse di Giovanni
Hièng-câung	Xuánzàng
Gū-chiŏng	Natiche
Mìng-chòng	Letto
Hāi-nàng	Hainan
Háng-ngṳ̄ Pĭng-ĭng	Pinyin
Uōng-dĕ̤ng	Estremo Oriente
Băh-gák	Columba livia
Găng-sé̤ṳk	Gansu
Taliban	Talebani
Huŏi-sáik	Grigio
Sĭng-mêng-gé	Deuteronomio
Sŭ-ciŭ	Suzhou
Ŭng-ciŭ	Wenzhou
Háng-cŭk	Han
Nìng-pŏ̤	Ningbo
Chói-chiŭ	Barba
Cāi-iêu	Aquilone
Hăk-ī-bĭng	Harbin
Mā-kì	Hirudinea
1000	1000 (numero)
Mìng-só-gé	Numeri (Bibbia)
Cáu-sèng	Cucina (architettura)
Hùng-nàng	Yunnan
Lō̤-uă	Corvus
Săng-dĕ̤ng	Shandong
È̤ng-ĕ̤ng	Chilopoda
Ò̤-nàng	Henan
Mì-mò̤	Sopracciglio
Bók-sài	Ombelico
Lièu-nìng	Liaoning
Hióng-liông	Vettore (matematica)
Cretaceous	Cretacico
Tochigi-gâing	Prefettura di Tochigi
Chói-mò̤-cēu	Alcedinidae
Dàu	Dado (gioco)
Cūi-nà̤	Cemento
Gék-lìng	Jilin (provincia)
Dĕ̤ng Dṳ̆ng-guók Hāi	Mar Cinese Orientale
Hāi-chĕk	Pirateria
Gūi	Fantasma
Bóng-dó̤	Rifiuti
Hù-nàng	Hunan
Jurassic	Giurassico
Chĭng-hāi	Qinghai
Mì-ngù-ī-cŭk	Uiguri
Ă-piéng	Oppio
Chiū-cī	Anello (gioiello)
Hù-báe̤k	Hubei
Săng-să̤	Shanxi
Cĕ̤ng-sáik	Marrone
Giòng-găng	Violenza sessuale
Gói-ciŭ	Guizhou
Triassic	Triassico
Sék-sáuk	Gryllidae
Cāi-piéu	Banconota
SQL	SQL
Hù Sék	Hu Shih
Iók-cṳ̆-ā-gé	Libro di Giosuè
Cŏng-cṳ̄	Zhuāngzǐ
Cṳ̀-hĭ Tái-hâiu	Cixi
Kan Naoto	Naoto Kan
Miyagi-gâing	Prefettura di Miyagi
模板:Commons category	Template:Commonscat
Lò̤-mā Cṳ̆	Lettera ai Romani
Pău-ŭk-siáng	Parabola (geometria)
Dô̤-dáik	Morale
Iwate-gâing	Prefettura di Iwate
Ĭ-siòng-chiă	Macchina per cucire
Dièu-siēng Lò̤-dông-dōng	Partito del Lavoro di Corea
Nàng-báe̤k-dièu	Dinastie del Nord e del Sud
Chái Ĭ-lìng	Jolin Tsai
Pì-lĭk-bī Cṳ̆	Lettera ai Filippesi
Ngā-gŏ-cṳ̆	Cantico dei cantici
Mā-lăk-gĭ-cṳ̆	Libro di Malachia
模板:Taxobox	Template:Tassobox
分類:Gŭng-ciō	Categoria:Sovrani
Diŏng Ngiê-mèu	Zhāng Yìmóu
模板:Dṳ̆ng-guók lĭk-sṳ̄	Template:Storia della Cina
Gĭng Céng-ŏng	Kim Jong-un
Liù-giù-ngṳ̄	Lingue ryukyuane
Mìng-ngṳ̄	Lingua min
Dài-uăng Mìng-nàng-ngṳ̄ Lò̤-mā-cê Pĭng-ĭng Huŏng-áng	Sistema di romanizzazione taiwanese
Gŏng-să̤	Jiangxi
Nìng-hâ	Ningsia
Lùng-sùng	Dragonboat
Noda Yoshihiko	Yoshihiko Noda
Yingluck Shinawatra	Yingluck Shinawatra
Siŏh-gă-cŏng	Shijiazhuang
Chṳ̄	Muroidea
Ciŏ-hāi	Zhuhai
Sáng-tàu	Shantou
Dâng-gŏng	Zhanjiang
Mùi-ciŭ	Meizhou
Chĭng-uōng	Qingyuan
Dĕ̤ng-uāng	Dongguan
Dṳ̆ng-săng-chê	Zhongshan
Dièu-ciŭ	Chaozhou
Tàng-táik	Siluriformes
Gé̤ṳk-huă	Chrysanthemum
Sofie gì Sié-gái	Il mondo di Sofia
Ordovician	Ordoviciano
Silurian	Siluriano
Hók-gióng-sēng (Dṳ̆ng-huà Mìng-guók)	Fujian (Taiwan)
Mièu-lĭk	Contea di Miaoli
Dāng-nòng	Cistifellea
Devonian	Devoniano
Hók-ciŭ	Fuzhou
Nàng-bìng	Nanping
Buò-dièng	Putian
Săng-mìng	Sanming
Ciòng-ciŭ	Quanzhou
Â-muòng	Xiamen
Ciŏng-ciŭ	Zhangzhou
Lṳ̀ng-ngàng	Longyan
Nìng-dáik	Ningde
Să̤-nìng	Xining
Să̤-iù-gé	Il viaggio in Occidente
Săng-guók Iēng-ngiê	Il romanzo dei tre regni
Cūi-hū	I Briganti (romanzo)
Ā-dŏng	Adamo
Aomori-gâing	Prefettura di Aomori
Fukushima-gâing	Prefettura di Fukushima
Tái-nguòng	Taiyuan
Hải Phòng	Haiphong
Sĭng-dé̤ṳk (gâing)	Contea di Hsinchu
Dâi-lièng	Dalian
Hĭ-Pŏ̤ Ciéng-cĕng	Guerre persiane
Permian	Permiano
Biēu-chĭng	Cugino
Cambrian	Cambriano
Iòng-ciók	Candela (illuminazione)
Chiba-gâing	Prefettura di Chiba
Pău	Citrus maxima
Lô-dáik-gé	Libro di Rut
Mà-hù	Anisoptera
Dáng-ī-lī	Libro di Daniele
Páuk-káik	Poker
Mô̤	Cappello
Gŏ̤-lìng-dŏ̤ Cièng Cṳ̆	Prima lettera ai Corinzi
Aichi-gâing	Prefettura di Aichi
Lī-ngṳ̀	Cyprinus carpio
Muāng-ciŭ	Manciuria
Sê̤ṳ-sṳ-gé	Libro dei Giudici
Pŏ̤-lìng-chái	Spinacia oleracea
Akita-gâing	Prefettura di Akita
Pièu-gĕng	Cucchiaio
Dê̤ṳ	Bacchette per il cibo
Mĕ̤k-lê	Jasminum
Nàng-dàu	Contea di Nantou
Gié-tiàng-chiă	Taxi
Â-hài	Mento
Gŭ	Fungo epigeo
Ibaraki-gâing	Prefettura di Ibaraki
Lài-gŭng	Tuono
Siĕu-sŏng	Acido nitrico
Ngù-giāng-kó	Blue-jeans
Bō̤-siŏh	Gemma (mineralogia)
Lièu-că̤ Cé-ê	Racconti straordinari dello studio Liao
Gáu-kuŏ-cṳ̆	Libro di testo
Chāu-māng	Caelifera
Diòng-chŭng	Changchun
Milan Kundera	Milan Kundera
Lâung	Uovo (alimento)
Lĕ̤k-sé Sê̤ṳ-giông	Protesta di piazza Tienanmen
Diêu Ciē-iòng	Zhao Ziyang
Hù Iêu-băng	Hu Yaobang
Fukuda Yasuo	Yasuo Fukuda
Sṳ̀ng-chéu (Sṳ̀ng-báh)	Pinaceae
Gī-hò̤-chiă	Compasso (strumento)
Táng-sŏng	Acido carbonico
Liòng-chióh	Riga (strumento)
Chăng-màng-chṳ̄	Talpidae
Dṳ̆ng-hâ Iâ cĭ Máe̤ng	Sogno di una notte di mezza estate
Tié-tàu-să-hô	Barbiere
Mā-kō̤ Hók Ĭng	Vangelo secondo Marco
Kaesŏng	Kaesŏng
Hwanghae Báe̤k-dô̤	Nord Hwanghae
P'yŏng'an Báe̤k-dô̤	Nord Pyongan
Hamgyŏng Báe̤k-dô̤	Nord Hamgyong
Hamgyŏng Nàng-dô̤	Sud Hamgyong
P'yŏng'an Nàng-dô̤	Sud Pyongan
Namp'o	Namp'o
Ryanggang Dô̤	Ryanggang
Tò̤-huòng	Contea di Taoyuan
Sŭk-mī	Riso glutinoso
Nguòng-siĕu-uòng	Tangyuan
Gĭng-dŭ	Prefettura di Kyoto
Ōsaka-hū	Prefettura di Osaka
Cék-ngṳ̀	Carassius auratus
Fukuoka-gâing	Prefettura di Fukuoka
Ehime-gâing	Prefettura di Ehime
Gŏ̤-lìng-dŏ̤, Hâiu Cṳ̆	Seconda lettera ai Corinzi
Sā̤-ĭ-gĭ	Lavatrice
Gék	Citrus reticulata
Gé̤ṳ	Sega (strumento)
Yamagata-gâing	Prefettura di Yamagata
Éu-dê-huòng	Scuola dell'infanzia
Dài-uăng Hāi-hiĕk	Stretto di Formosa
Lù-guói	Aloe (botanica)
Yamaguchi-gâing	Prefettura di Yamaguchi
Kanagawa-gâing	Prefettura di Kanagawa
Nagano-gâing	Prefettura di Nagano
Iĕng-huă	Fuochi d'artificio
Mì-pŏ̤-lù	Forno a microonde
Saitama-gâing	Prefettura di Saitama
Mie-gâing	Prefettura di Mie
Hĭ-báik-lài Cṳ̆	Lettera agli Ebrei
Gă-lăk-tái Cṳ̆	Lettera ai Galati
Muàng-ngṳ̀	Anguilliformes
Siŏng-dièu	Dinastia Shang
Gunma-gâing	Prefettura di Gunma
Hyōgo-gâing	Prefettura di Hyōgo
Miyazaki-gâing	Prefettura di Miyazaki
Kumamoto-gâing	Prefettura di Kumamoto
Ă-cì	Cicadidae
Koizumi Jun'ichirō	Jun'ichirō Koizumi
Ī-sê̤ṳ-táik-cṳ̆	Libro di Ester
Diòng-dô-cṳ̆	Qoelet
Hatoyama Yukio	Yukio Hatoyama
Gŏ̤-lò̤-să̤ Cṳ̆	Lettera ai Colossesi
Ngā-gáuk Cṳ̆	Lettera di Giacomo
Iók-hâng Ék Cṳ̆	Prima lettera di Giovanni
Pì-lé-muòng Cṳ̆	Lettera a Filemone
Táik-sák-lò̤-nà̤-giă, Hâiu Cṳ̆	Seconda lettera ai Tessalonicesi
Táik-sák-lò̤-nà̤-giă Cièng Cṳ̆	Prima lettera ai Tessalonicesi
Bī-dáik Cièng Cṳ̆	Prima lettera di Pietro
Bī-dáik Hâiu Cṳ̆	Seconda lettera di Pietro
Tì-mò̤-tái Cièng Cṳ̆	Prima lettera a Timoteo
Dòng-lòng	Mantodea
Gifu-gâing	Prefettura di Gifu
Ishikawa-gâing	Prefettura di Ishikawa
Nara-gâing	Prefettura di Nara
Wakayama-gâing	Prefettura di Wakayama
Shizuoka-gâing	Prefettura di Shizuoka
Shiga-gâing	Prefettura di Shiga
Iók-hâng Nê Cṳ̆	Seconda lettera di Giovanni
Ī-suói-ā-cṳ̆	Libro di Isaia
Iók-hâng Săng Cṳ̆	Terza lettera di Giovanni
Iù-dâi Cṳ̆	Lettera di Giuda
Tì-mò̤-tái Hâiu Cṳ̆	Seconda lettera a Timoteo
Tì-dŏ̤ Cṳ̆	Lettera a Tito
Nùng-mìng	Agricoltore
Ià-lé-mī-cṳ̆	Libro di Geremia
Ī-sê̤ṳ-lá-cṳ̆	Libro di Esdra
Nà̤-hĭ-mī-cṳ̆	Libro di Neemia
Iók-ngī-cṳ̆	Libro di Gioele
Băh-lô	Egretta garzetta
Chŭng-cáik	Capodanno cinese
Sō-siè	Chiave (serratura)
Abe Shinzō	Shinzō Abe
Asō Tarō	Tarō Asō
Séng-cṳ̆-tā̤	Geroglifici egizi
Niigata-gâing	Prefettura di Niigata
Yamanashi-gâing	Prefettura di Yamanashi
Shimane-gâing	Prefettura di Shimane
Toyama-gâing	Prefettura di Toyama
Okayama-gâing	Prefettura di Okayama
Kă-tōi	Zampa
Piăng	Schiena
Piĕ	Lettera (messaggio)
Sáik-màng	Daltonismo
Carboniferous	Carbonifero
Ciŏng-huá	Contea di Changhua
Fukui-gâing	Prefettura di Fukui
Ōita-gâing	Prefettura di Ōita
Tottori-gâing	Prefettura di Tottori
Nùng-lĭk	Calendario cinese
Kōchi-gâing	Prefettura di Kōchi
Uâng-iū īng-lĭk dêng-lŭk	Legge di gravitazione universale
Chèng-gēng	Bombyx mori
Dài-uăng Nĭk-buōng Sì-dâi	Taiwan sotto il dominio giapponese
Páuk Gê̤ṳng-hiê	Park Geun-hye
Dài-nàng	Tainan
Cĕng	Ago (cucito)
Muāng-cŭk	Manciù
Kìng-giāng	Pinza
Anna Karenina	Anna Karenina
Tài-nè̤ng	Omicidio
Gáung-gṳ̆ng	Armatura (edilizia)
Tiè-mà	Pianto
Swadesh hŏk-sĭng-sṳ̀ liĕk-biēu	Lista di Swadesh
Dŭng-nìng-guók	Regno di Tungning
Hùng-lìng	Yunlin
Diāng	Casseruola
Lāng	Saliva
Diò-să-hô	Cuoco
Bĭng-lòng	Areca catechu
Dâi-céng Tiĕng-huòng	Taisho
Băng-sièng Lā-mà	Panchen Lama
Mŭk-gê̤ṳng	Hibiscus syriacus
Muòi-huă	Prunus mume
Cĕ̤ng-chéu	Trachycarpus fortunei
Muòi-kṳ̄ng	Muffa
Sĕ̤ng-săng-giāng	Gemelli (biologia)
Mĕ̤k-tiák	Ciglia (occhi)
Nguòng-cṳ̄-bék	Penna a sfera
Norodom Sihanouk	Norodom Sihanouk
Saga-gâing	Prefettura di Saga
Tokushima-gâing	Prefettura di Tokushima
Lòng-dâung	Hyoscyamus niger
Lòi-sĭ-gā	Cacciavite
Kēng-muōi-dăi	Setaria italica
Sĭk-sĭk	Ala (aeronautica)
Kagawa-gâing	Prefettura di Kagawa
Thaksin Shinawatra	Thaksin Shinawatra
Uòng-dăi	Panicum miliaceum
Kê	Diospyros
Săng-guók (Dièu-siēng)	Tre regni di Corea
Ŭng-dìng	Polvere
Huăng-siŏh-liù	Psidium guajava
Duâi-tàu-giáng	Lente d'ingrandimento
Gă-ngiê (gâing)	Contea di Chiayi
Ĭ-gŭng	Nonno
Puái-dáu	Mezzogiorno (parte del giorno)
Huōi-căi	Incendio
Chiū-ló̤h	Guanto
Nagasaki-gâing	Prefettura di Nagasaki
Hâ-dièu	Dinastia Xia
Cá̤-nàng	Jinan
Dṳ̆ng-guók Káung-nĭk Ciéng-cĕng	Seconda guerra sino-giapponese
Sarawak	Sarawak
Hŭng-cūi	Feng shui
Chiéu	Risata
Ngô̤-mâng gâe̤ng Piĕng-giéng	Orgoglio e pregiudizio
Oda Nobunaga	Oda Nobunaga
Lī Sìng-uāng	Syngman Rhee
Iòng-bék-chó̤	Gomma per cancellare
Nàng-chiŏng	Nanchang
Tokugawa Ieyasu	Tokugawa Ieyasu
Bók-séu-gáung	Acciaio inossidabile
Sáu-chiū	Scopa (strumento)
Dŭk-cài	Autocrazia
Kŭng-dièu	Condizionatore d'aria
Diòng-să	Changsha
Pèng	Vernice
Mìng-dê Tiĕng-huòng	Meiji
Kă-âu-dăng	Tallone (anatomia)
Ā-mò̤-sê̤ṳ-cṳ̆	Libro di Amos
Ŏ̤-bă-dī-ā-cṳ̆	Libro di Abdia
Itō Hirobumi	Hirobumi Itō
Nguŏh	Giada
Só-gé̤ṳ-kó guāng-lī hiê-tūng	Database management system
Dâu-hô	Tōfu
Mì-hèu	Macaca
Mī-giă-cṳ̆	Libro di Michea
Bù-sák	Bodhisattva
Hăk-gĭ-cṳ̆	Libro di Aggeo
Ī-să̤-giék	Libro di Ezechiele
Chiū-biēu	Orologio da polso
ASP.NET	ASP.NET
Iók-nā-cṳ̆	Libro di Giona
Sabah	Sabah
Ià-lé-mī-ăi-gŏ̤	Libro delle Lamentazioni
Tái-gáng	Eunuco
Nàng-nìng	Nanning
Ê-só	Glutammato monosodico
Nā-ŭng-cṳ̆	Libro di Naum
Hăk-bă-gók-cṳ̆	Libro di Abacuc
Sák-gā-lé-ă-cṳ̆	Libro di Zaccaria
Guók-gê̤ṳng Nô̤i-ciéng	Guerra civile cinese
Uŏk-nàng Gê̤ṳng-huò-guók	Vietnam del Sud
Chiĕu-chê	Supermercato
Ciŏng Cṳ̄-ì	Zhang Ziyi
Lák-tàu	Alopecia androgenetica
Gulliver Lṳ̄-hèng-gé	I viaggi di Gulliver
Gŏ̤-hṳ̀ng	Kaohsiung
Naha-chê	Naha
Buŏk-hāi	Mare di Bohai
Báh-chói	Sbadiglio
Hâung Ṳ̄	Xiang Yu
Putrajaya	Putrajaya
Kŏng-mìng	Kunming
Nĭk-guŏng-dĕng	Lampada fluorescente
Jane Eyre	Jane Eyre
Johor	Johor
Ngâung	Ritardo mentale
Huòi-cŭk	Hui (popolo)
Làng-ciŭ	Lanzhou
Hŏ̤-să̤-cṳ̆	Libro di Osea
Tiék-cĭng	Ruggine
Dĕ̤ng-kiĕ	Sepiida
Lìng Cáik-sṳ̀	Lin Zexu
Săng-guók	Tre Regni
Chŭng-chiŭ Sì-dâi	Periodo delle primavere e degli autunni
Ciéng-guók Sì-dâi	Periodo dei regni combattenti
Puō-ngì	Pu Yi
Mā-lăk-gă	Malacca
Oracle	Oracle
Hăk-bùi	Hefei
Huák-lùng-gŭng	Falun Dafa
Kelantan	Kelantan
Lŏk-iòng	Luoyang
Toyotomi Hideyoshi	Toyotomi Hideyoshi
Kana	Kana
Câung-cŭk	Tibetani
Pulau Pinang	Penang
Hamasaki Ayumi	Ayumi Hamasaki
Să̤-huăng-ngā-cṳ̆	Libro di Sofonia
Dâi-nĭk-buōng Dá̤-guók	Impero giapponese
Hṳ̆ng-nù	Xiongnu
Mâing-cṳ̄	Mencio
Kedah	Kedah
Perak	Perak
Hŏk-ôi	Laurea
Gié-lìng	Guilin
Terengganu	Terengganu
Selangor	Selangor
Iòng (dông-ŭk)	Caprinae
Hāi-kāu	Haikou
Chāu-buōng sĭk-ŭk	Erba
Pahang	Pahang
Bă-là̤ Séng-mū-iêng (Siēu-siók)	Notre-Dame de Paris (Victor Hugo)
Chiông-gì	Xiangqi
Yun Chi-ho	Yun Chi-Ho
Gói-iòng	Guiyang
Gáung-bék	Penna stilografica
Ngù Dìng-iēng	Ngô Đình Diệm
Gô-dā̤	Passato
Dĭng-hiŏng-kó̤	Engraulidae
Miêng	Noodles
Hiêng-câi	Presente (tempo)
Lèng-gēng	Dimocarpus longan
Mì-lĕk-hŭk	Maitreya
Guăng-ĭng	Avalokitesvara
Bìng-dĕ̤ng	Contea di Pingtung
Gēu-gī	Lycium barbarum
Lĕ̤k-dèu-gáuk	Costa (anatomia)
Dâng Sìng-gŭng	Koxinga
Nguŏk-biāng	Torta lunare
Cṳ̆-gák Liông	Zhuge Liang
Ció-ĭng Hù-hô̤	Bopomofo
Tù-kēng	Gryllotalpidae
Dṳ̆ng-guók Ìng-mìng Gāi-huóng-gŭng	Esercito Popolare di Liberazione
Sìng-ū Tiĕng-huòng	Jinmu
Ciē-chái	Nori
Dennis Rodman	Dennis Rodman
È̤ng-dà	Tè nero
Cò̤ Chó̤	Cáo Cāo
Tài-tàu	Decapitazione
Cūi-ngù	Cerambycidae
Buŏi	Volo
Ŭi-nà̤-sṳ̆ Sĕng-lī-nè̤ng	Il mercante di Venezia
Ū-ì-săng	Monte Wuyi
Ŭ-sŭ-lī-gĕ̤ng	Ussuri
Tiĕng-huòng	Imperatore del Giappone
Kăi-hŭng	Kaifeng
Sĭng-dài-bê	Dollaro taiwanese
Nguòng Sié-kāi	Yuan Shikai
John Wesley	John Wesley
Siăh	Alimentazione
Perlis	Perlis
Negeri Sembilan	Negeri Sembilan
Labuan	Labuan
Lṳ̀ng	Drago cinese
Iòng-iù-gàu	Lampada a cherosene
Cần Thơ	Cần Thơ
Gĭng-cŭk	Việt
Ciĕng-bò̤	Champa
Diòng-gáu-sê̤ṳ	Missionario
Uōng-dâi Cièng-tiàng	Grandi speranze
Niōng-bēng	Soffitto
Rasŏn	Rasŏn
Guăng Ṳ̄	Guan Yu
Ŭ-gŭi	Testudines
Tá̤	Cassetto
Gê̤ṳng-huò-dōng	Partito Repubblicano
Bō̤-dâi Huòng-dá̤	Bảo Đại
Siê-iù	Salsa di soia
Ŭ-lṳ̀ng-dà	Oolong
Gê̤ṳng-sāng-dōng	Partito comunista
Chái Ĭng-ùng	Tsai Ing-wen
Ŏ̤-mì-tò̤-hŭk	Amitabha Buddha
Ngiè-làng	Contea di Yilan
Ciŭ Giĕk-lùng	Jay Chou
Orhan Pamuk	Orhan Pamuk
Carpineto Romano	Carpineto Romano
Ngū-dâi Sĕk-guók	Cinque dinastie e dieci regni
Cō̤	Ziziphus jujuba
Tā̤-ṳ̆k	Educazione fisica
Sĭng-báe̤k	Nuova Taipei
Dài-dṳ̆ng	Taichung
Làu Bê	Liu Bei
Huă-lièng	Contea di Hualien
Gĭng-muòng	Kinmen
Dài-dĕ̤ng	Contea di Taitung
Sĭng-dé̤ṳk (chê)	Hsinchu
Gă-ngiê (chê)	Chiayi
Giĕ-lè̤ng	Keelung
Jun Ji-hyun	Jun Ji-hyun
Dièu-siēng Gŏ̤-cŭng	Gojong di Corea
Gáuk-gáuk	Osso
Amuro Namie	Namie Amuro
Diêng-tù	Pila (elettrotecnica)
Gê̤ṳ-gê̤ṳ	Stampella
Nakashima Mika	Mika Nakashima
Hù-lì-mà	Mustela sibirica
Gŏ̤-ák-guŏ	Pentola a pressione
Chagang Dô̤	Chagang
Sŏng-ngù	Regno Wu
Băh-cŭk	Bai (popolo)
Â-dáu	Pomeriggio
Huòng Tái-gĭk	Huang Taiji
Guŏng-sê̤ṳ Huòng-dá̤	Guangxu
Alan Dawa Dolma	Alan Dawa Dolma
Ngù-mō̤-ngù-giāng	Chiocciola
Takeshi Kaneshiro	Takeshi Kaneshiro
Sông-dê Huòng-dá̤	Shunzhi
Sŏng Guòng	Sun Quan
Cò̤ Pī	Cao Pi
Ciōng Gĭng-guók	Chiang Ching-kuo
Uòng Mì	Wang Wei
Lī Dĕng-hŭi	Lee Teng-hui
Ṳ̆ng-céng Huòng-dá̤	Yongzheng
Dùng-dê Huòng-dá̤	Tongzhi
Dŭng-huòng	Dunhuang
Să-mŏk	Erg (deserto)
Hiŏng-iòng-guă	Sechium edule
Uòng Ăng-sĭk	Wang Anshi
Tokugawa Yoshimune	Tokugawa Yoshimune
Săng-ā	Sanya
Dài-uăng Mìng-ciō-guók	Repubblica di Taiwan (1895)
Guók-ngṳ̄	Lingua nazionale
Sṳ̆k-háng	Regno Shu
Cò̤-ngôi	Regno Wei
Hiŏng-gŭ	Lentinula edodes
Mŭk-ngī	Auricularia auricula-judae
Gă-kéng Huòng-dá̤	Jiaqing
Dô̤-guŏng Huòng-dá̤	Daoguang
Hièng-hŭng Huòng-dá̤	Xianfeng
Gĭng-kiŏk	Opera di Pechino
Bău Cīng	Bao Zheng
Báik-guá	Bagua
Sṳ̆-mā Hé	Sima Yi
Áng-pŭng	Ampulex compressa
Hŭng-sṳ̆k	Convenzione (diritto)
Ièu-cŭk	Yao (popolo)
Bĭng-sĭng	Bing Xin
Biék	Trionychidae
Báik-nguŏk-cáik	Festa di metà autunno
Liŏh-chiông-gĭ	Videoregistratore
Dâng-chái	Mytilidae
Gā-cō̤	Siphonaptera
Dài-uăng Muāng-chĭng Sì-dâi	Taiwan sotto il dominio della dinastia Qing
Mā-tái Hók Ĭng	Vangelo secondo Matteo
Sĕk-cê-gá	Croce cristiana
Ī-hók-sū Cṳ̆	Lettera agli Efesini
Sìng	Sing
Mā-cū (Sìng)	Dea dei Mari
Mìng	Ming (disambigua)
Uŏk-nàng Gê̤ṳng-sāng-dōng	Partito Comunista del Vietnam
10000	10000
Kū-guă	Momordica charantia
Mìng-miâng Huòng-dá̤	Minh Mạng
Chék Gié-guŏng	Qi Jiguang
Ì-cŭk	Yi (popolo)
Gāu-nguŏk-gāu	Giorno dei crisantemi
Dâing Lâ̤-gŭng	Teresa Teng
Mìng-sìng Huòng-hâiu	Myeongseong di Joseon
Sê̤ṳ-dáik Huòng-dá̤	Tự Đức
Cṳ̀-ciŏng	Piastrella
Gŏ̤ Dé-sêng	Gao Zhisheng
Hàng Hàng	Han Han
Ók-dāu	Ferro da stiro
Liŏh-dà	Tè verde
Liŏh-dâu	Vigna radiata
Dièu-siēng-cŭk	Coreani
Hŭk-dáng Dâi-hŏk	Università Fudan
Kŭmgang-săng Guăng-guŏng Dê-kṳ̆	Regione turistica di Kŭmgangsan
Gă-săk-giāng	Superutilitaria
Gái-chái	Brassica juncea
Siông-hāi Gău-tŭng Dâi-hŏk	Università Jiao Tong di Shanghai
Bù-sìng	Muscidae
Ciū-ciòng	Jiuquan
Hŭ-huò-hô̤-dĕk	Hohhot
Hà-iù	Salsa di pesce
Băh-ngiê	Isoptera
Băh-uâ-cê	Pe̍h-ōe-jī
Páu-diông	Miccetta
Hṳ̆ng-dòng	Torace
Mā-cū (Dō̤)	Isole Matsu
Să̤-cŏng	Abito completo da uomo
Ìng-cṳ̄	Figlio dell'uomo
Hiroshima-gâing	Prefettura di Hiroshima
Hwanghae Nàng-dô̤	Sud Hwanghae
Siĕu-ciū	Baijiu
Dùng-cé	Compagno (politica)
Hŭng-tiŭ	Pompa per bicicletta
Káh-gă	Hakka (popolo)
Bâng-ā	Mutismo
Nàng-gĭng Dâi-hŏk	Università di Nanchino
Chék-nguŏk-buáng	Ullambana
Uòng Sĭng-lìng	Cyndi Wang
Hù-siŭ	Misgurnus anguillicaudatus
Cò̤ Sĭk	Cao Zhi
Mìng-nàng-nè̤ng	Hoklo
Buò-gì	Livistona chinensis
Dièu-siēng Buáng-dō̤ lĭk-sṳ̄	Storia della Corea
Cáe̤ng	Zongzi
Sinŭiju Dĕk-biék Hèng-céng-kṳ̆	Regione amministrativa speciale di Sinuiju
Tūng-ék Sĭng-lò̤	Unificazione Silla
Dìng Gīng-ê̤ṳng	Chen Jingrun
Lìng Chṳ̆	Lin Shu
Hók-gióng tū-làu	Tulou
Chĭng-mìng	Festa di Qingming
Nê-hù	Erhu
Siă-cŭk	She (popolo)
Mē̤ng-giāng	Psychodidae
Mĭk-pŭng	Apidae
Okinawa-gâing	Prefettura di Okinawa
Diòng-lŏ̤h	Changle
Nàng-ā	Asia meridionale
Báh-uŏk	Yue (popolo)
Gŭng-sĭ	Azienda
Tì-kŭ	Scomber japonicus
Nàng-uŏk-guók	Nanyue
Hâ-uă	Eva
Chèng-chṳ̄	Arvicolinae
Kiŏng-cŭk	Qiang
Wiki Bô-lâung-diòng	Wikimedia Incubator
Bĭng-dê̤ṳ	Ghiacciolo (gelato)
Wikipedia:Sū-iū ngṳ̄-ngiòng bēng-buōng gì Wikipedia	Wikipedia:Tutte le lingue
Ngṳ̆k-huòng-dâi-dá̤	Imperatore di Giada
Ngù-sāi-gŭi	Scarabeo stercorario
À̤-liák	Pantofola
Cé̤ṳk	Congee
Pàng-hù Gùng-dō̤	Isole Penghu
Muōi-sì	Eleocharis dulcis
Ôi	Stomaco
Hāi-gēu	Arctocephalinae
Sibu	Sibu
Cṳ̆-dó̤h	Scrivania
Siông Ièng	Shō En
Aragaki Yui	Yui Aragaki
Siông Tái-giū	Shō Taikyū
Siĕu	Dizi
Mā-lái-iè	Heteropoda venatoria
Káh-dièu	Gioco
Siŏh-màng	Ieri
Gák-lì	Vongola
Dṳ̀-huák	Divisione (matematica)
Hù-lù	Lagenaria siceraria
Diêng-dĕng	Lampadina
Siông Bă-cé	Shō Hashi
Ùng-dé̤ṳk	Asparagus setaceus
分類:Dáik-guók	Categoria:Germania
分類:É-dâi-lé	Categoria:Italia
分類:Mī-guók	Categoria:Stati Uniti d'America
分類:Ngò̤-lò̤-sṳ̆	Categoria:Russia
分類:Dṳ̆ng-guók	Categoria:Cina
分類:Nĭk-buōng	Categoria:Giappone
分類:Ó̤-ciŭ	Categoria:Australia
分類:Éng-nà̤	Categoria:Indonesia
分類:Hàng-guók	Categoria:Corea del Sud
分類:Tái-guók	Categoria:Thailandia
分類:Uŏk-nàng	Categoria:Vietnam
分類:Buô-ṳ̄ dông-ŭk	Categoria:Mammiferi
分類:Bà-hèng dông-ŭk	Categoria:Rettili
分類:Cēu	Categoria:Uccelli
分類:Cĭng-kṳ̄ng	Categoria:Fungi
分類:Sĭk-ŭk	Categoria:Piante
分類:Ŭk-lī	Categoria:Fisica
分類:Huá-hŏk	Categoria:Chimica
分類:Lĭk-sṳ̄	Categoria:Storia
分類:Dê-lī	Categoria:Geografia
分類:Siâ-huôi	Categoria:Società
分類:Mī-sŭk	Categoria:Arti visive
分類:Cŭng-gáu	Categoria:Religione
分類:Tā̤-ṳ̆k	Categoria:Sport
分類:Kuŏ-hŏk	Categoria:Scienza
分類:Gióng-dé̤ṳk-ŭk	Categoria:Edifici
Gū Lò̤-mā	Civiltà romana
Regina Duarte	Regina Duarte
Cūi-kì	Lumaca
分類:Sĕng-tái	Categoria:Ecologia
分類:Disambig	Categoria:Pagine di disambiguazione
分類:Diék-hŏk	Categoria:Filosofia
分類:Sĭng-lī	Categoria:Psicologia
分類:Hŭk-gáu	Categoria:Buddhismo
分類:Gĭ-dók-gáu	Categoria:Cristianesimo
分類:Ĭ-sṳ̆-làng-gáu	Categoria:Islam
分類:Iù-tái-gáu	Categoria:Ebraismo
Mā-cū	Matsu
Hô-dê̤ṳ	Yuba (cibo)
Gùng	Gonna
Tuyên Quang	Provincia di Tuyen Quang
Iraq gâe̤ng Levant Ĭ-sṳ̆-làng-guók	Stato Islamico
Â-muòng-uâ	Lingua amoy
Tău-dò̤-nó̤h	Furto
Ciĕ-muài	Sesamum indicum
Abu Bakr al-Baghdadi	Abu Bakr al-Baghdadi
分類:Ùng-huá	Categoria:Cultura
分類:Dê-cék	Categoria:Geologia
模板:Tái-iòng-hiê	Template:Sistema solare
Kō̤-cṳ̆	Test standardizzato
Ciē-sáik	Porpora
Gâng	Sudorazione
Ák	Anatra
Duâi-tàu-chái	Brassica rapa rapa
Huăng-siông	Mangifera indica
分類:Dáik-guók ìng-ŭk	Categoria:Tedeschi
分類:Mī-guók ìng-ŭk	Categoria:Statunitensi
分類:Iēng-uòng	Categoria:Attori
分類:Ĭng-guók ìng-ŭk	Categoria:Britannici
分類:Huák-guók ìng-ŭk	Categoria:Francesi
模板:Chess diagram	Template:Diagramma scacchi
模板:Tl	Template:Tl
分類:Guók-gă	Categoria:Nazioni
Wikipedia:Hèng-céng Ìng-uòng	Wikipedia:Amministratori
分類:Dṳ̆ng-guók mìng-cŭk	Categoria:Gruppi etnici in Cina
分類:Ìng-ŭk	Categoria:Persone
分類:Cék-ngiĕk	Categoria:Professioni
Wikipedia:Gĭ-ké-nè̤ng	Wikipedia:Bot
分類:Sì-găng	Categoria:Tempo
分類:Gĕ̤ng-tiàng	Categoria:Ingegneria
分類:Cài-lâiu	Categoria:Materiali
分類:Ĭ-hŏk	Categoria:Medicina
分類:Céng-dê	Categoria:Politica
分類:Gáu-ṳ̆k	Categoria:Educazione
Ăi-gĭk	Egitto
模板:Bot	Template:Bot
Nizhneleninskoye	Nižneleninskoe
Gă-nā-dâi	Canada
分類:Iù-hié	Categoria:Giochi
分類:Ĕu-ciŭ guók-gă	Categoria:Stati dell'Europa
分類:Ĕu-ciŭ	Categoria:Europa
模板:Documentation	Template:Man
分類:Ê̤ṳng-hô	Categoria:Utenti per lingua
Sìng Câi-gĭ	Sung Jae-gi
模板:Softredirect	Template:Soft redirect
Wikipedia:維基數據	Aiuto:Wikidata
模板:Chēng	Template:Cancella subito
分類:Ngṳ̄-ngiòng	Categoria:Lingue
分類:Lĭk-huák	Categoria:Calendari
分類:Wikipedia	Categoria:Wikipedia
Wikipedia:Mò̤ hô-cáik sĭng-mìng	Wikipedia:Avvertenze generali
分類:未索引其頁面	Categoria:Pagine non indicizzate
Huòng-huō Diòng-siàng	Great Firewall
模板:Smallcaps	Template:Maiuscoletto
模板:Nowrap	Template:Tutto attaccato
Wikipedia:Ék-chiék Wikipedia dŭ găi-dŏng ô gì ùng	Wikipedia:Lista delle voci che tutte le Wikipedie dovrebbero avere
分類:Hĭ-ciŭ	Categoria:Africa
模板:Wikisource	Template:Wikisource
模板:Babel	Template:Babel
模板:Commons	Template:Commons
模板:Reflist	Template:References
Wikipedia:列明來源	Aiuto:Uso delle fonti
模板:Stub	Template:S
模板:User eo-1	Template:Utente eo-1
模板:User eo-3	Template:Utente eo-3
模板:User de	Template:Utente de
模板:User de-1	Template:Utente de-1
模板:User es	Template:Utente es
模板:User de-3	Template:Utente de-3
模板:User en-3	Template:Utente en-3
模板:User en-1	Template:Utente en-1
模板:User en-2	Template:Utente en-2
模板:User eo-2	Template:Utente eo-2
模板:User en-4	Template:Utente en-4
模板:User en	Template:Utente en
模板:User de-2	Template:Utente de-2
模板:User es-1	Template:Utente es-1
模板:User fr-1	Template:Utente fr-1
模板:User it-3	Template:Utente it-3
模板:User fr-2	Template:Utente fr-2
模板:User ja	Template:Utente ja
模板:User ja-1	Template:Utente ja-1
模板:User it-1	Template:Utente it-1
模板:User fr	Template:Utente fr
分類:Ā-ciŭ	Categoria:Asia
分類:Nàng Mī-ciŭ	Categoria:America meridionale
分類:Mā-lài-să̤-ā	Categoria:Malesia
模板:Mod	Template:Mod
模板:User it	Template:Utente it
模板:User es-2	Template:Utente es-2
模板:Huăng-ngìng	Template:Benvenuto
分類:Dièu-lâiu	Categoria:Condimenti
分類:User fr-1	Categoria:Utenti fr-1
模板:Image label	Template:Etichetta immagine
模板:Wiki gĕ̤ng-tiàng	Template:Wikimedia
模板:Steady	Template:Stabile
模板:Guók-gă	Template:Stato
模板:Cite journal	Template:Cita pubblicazione
模板:Infobox 公司	Template:Azienda
模板:Hō̤ gì ùng-ciŏng	Template:Vetrina
分類:User en-4	Categoria:Utenti en-4
分類:User en	Categoria:Utenti en
分類:User zh	Categoria:Utenti zh
分類:User zh-M	Categoria:Utenti zh-M
分類:User en-2	Categoria:Utenti en-2
模板:Infobox	Template:Infobox
模板:User eo	Template:Utente eo
模板:User zh	Template:Utente zh
分類:Gáuk-guók gì lĭk-sṳ̄	Categoria:Storia per nazione
Wikipedia:Dŏng-nièng gĭng-dáng/09 nguŏk 23 hô̤	Template:PaginaPrincipale/Attualita/23 settembre
Wikipedia:Dŏng-nièng gĭng-dáng/09 nguŏk 22 hô̤	Template:PaginaPrincipale/Attualita/22 settembre
模板:Legend	Template:Legenda
Wikipedia:Dŏng-nièng gĭng-dáng/09 nguŏk 17 hô̤	Template:PaginaPrincipale/Attualita/17 settembre
Wikipedia:Dŏng-nièng gĭng-dáng/10 nguŏk 15 hô̤	Template:PaginaPrincipale/Attualita/15 ottobre
模板:Cite web	Template:Cita web
Wikipedia:Dŏng-nièng gĭng-dáng/09 nguŏk 28 hô̤	Template:PaginaPrincipale/Attualita/28 settembre
Wikipedia:Dŏng-nièng gĭng-dáng/10 nguŏk 22 hô̤	Template:PaginaPrincipale/Attualita/22 ottobre
Wikipedia:Dŏng-nièng gĭng-dáng/11 nguŏk 2 hô̤	Template:PaginaPrincipale/Attualita/2 novembre
Wikipedia:Dŏng-nièng gĭng-dáng/11 nguŏk 9 hô̤	Template:PaginaPrincipale/Attualita/9 novembre
Wikipedia:Dŏng-nièng gĭng-dáng/10 nguŏk 1 hô̤	Template:PaginaPrincipale/Attualita/1 ottobre
Wikipedia:Dŏng-nièng gĭng-dáng/10 nguŏk 5 hô̤	Template:PaginaPrincipale/Attualita/5 ottobre
Wikipedia:Dŏng-nièng gĭng-dáng/10 nguŏk 8 hô̤	Template:PaginaPrincipale/Attualita/8 ottobre
分類:Īng-sĭk	Categoria:Alimentazione
模板:MongolUnicode	Template:MongolUnicode
Wikipedia:Dŏng-nièng gĭng-dáng/10 nguŏk 6 hô̤	Template:PaginaPrincipale/Attualita/6 ottobre
Wikipedia:Dŏng-nièng gĭng-dáng/10 nguŏk 17 hô̤	Template:PaginaPrincipale/Attualita/17 ottobre
Wikipedia:Dŏng-nièng gĭng-dáng/10 nguŏk 2 hô̤	Template:PaginaPrincipale/Attualita/2 ottobre
Wikipedia:Dŏng-nièng gĭng-dáng/09 nguŏk 16 hô̤	Template:PaginaPrincipale/Attualita/16 settembre
Wikipedia:Dŏng-nièng gĭng-dáng/09 nguŏk 19 hô̤	Template:PaginaPrincipale/Attualita/19 settembre
Wikipedia:Dŏng-nièng gĭng-dáng/10 nguŏk 25 hô̤	Template:PaginaPrincipale/Attualita/25 ottobre
Wikipedia:Dŏng-nièng gĭng-dáng/11 nguŏk 10 hô̤	Template:PaginaPrincipale/Attualita/10 novembre
Wikipedia:Dŏng-nièng gĭng-dáng/10 nguŏk 21 hô̤	Template:PaginaPrincipale/Attualita/21 ottobre
Wikipedia:Dŏng-nièng gĭng-dáng/09 nguŏk 15 hô̤	Template:PaginaPrincipale/Attualita/15 settembre
Wikipedia:Dŏng-nièng gĭng-dáng/09 nguŏk 4 hô̤	Template:PaginaPrincipale/Attualita/4 settembre
Wikipedia:Dŏng-nièng gĭng-dáng/09 nguŏk 8 hô̤	Template:PaginaPrincipale/Attualita/8 settembre
Wikipedia:Dŏng-nièng gĭng-dáng/10 nguŏk 4 hô̤	Template:PaginaPrincipale/Attualita/4 ottobre
Wikipedia:Dŏng-nièng gĭng-dáng/09 nguŏk 1 hô̤	Template:PaginaPrincipale/Attualita/1 settembre
Wikipedia:Dŏng-nièng gĭng-dáng/09 nguŏk 6 hô̤	Template:PaginaPrincipale/Attualita/6 settembre
Wikipedia:Dŏng-nièng gĭng-dáng/09 nguŏk 25 hô̤	Template:PaginaPrincipale/Attualita/25 settembre
Wikipedia:Dŏng-nièng gĭng-dáng/09 nguŏk 10 hô̤	Template:PaginaPrincipale/Attualita/10 settembre
Wikipedia:Dŏng-nièng gĭng-dáng/09 nguŏk 26 hô̤	Template:PaginaPrincipale/Attualita/26 settembre
Wikipedia:Dŏng-nièng gĭng-dáng/09 nguŏk 20 hô̤	Template:PaginaPrincipale/Attualita/20 settembre
Wikipedia:Dŏng-nièng gĭng-dáng/11 nguŏk 4 hô̤	Template:PaginaPrincipale/Attualita/4 novembre
Wikipedia:Dŏng-nièng gĭng-dáng/09 nguŏk 30 hô̤	Template:PaginaPrincipale/Attualita/30 settembre
Wikipedia:Dŏng-nièng gĭng-dáng/10 nguŏk 7 hô̤	Template:PaginaPrincipale/Attualita/7 ottobre
Wikipedia:Dŏng-nièng gĭng-dáng/10 nguŏk 19 hô̤	Template:PaginaPrincipale/Attualita/19 ottobre
Wikipedia:Dŏng-nièng gĭng-dáng/09 nguŏk 27 hô̤	Template:PaginaPrincipale/Attualita/27 settembre
Wikipedia:Dŏng-nièng gĭng-dáng/09 nguŏk 11 hô̤	Template:PaginaPrincipale/Attualita/11 settembre
Wikipedia:Dŏng-nièng gĭng-dáng/11 nguŏk 8 hô̤	Template:PaginaPrincipale/Attualita/8 novembre
Wikipedia:Dŏng-nièng gĭng-dáng/11 nguŏk 1 hô̤	Template:PaginaPrincipale/Attualita/1 novembre
Wikipedia:Dŏng-nièng gĭng-dáng/11 nguŏk 7 hô̤	Template:PaginaPrincipale/Attualita/7 novembre
Wikipedia:Dŏng-nièng gĭng-dáng/10 nguŏk 11 hô̤	Template:PaginaPrincipale/Attualita/11 ottobre
Wikipedia:Dŏng-nièng gĭng-dáng/11 nguŏk 3 hô̤	Template:PaginaPrincipale/Attualita/3 novembre
Wikipedia:Dŏng-nièng gĭng-dáng/10 nguŏk 20 hô̤	Template:PaginaPrincipale/Attualita/20 ottobre
Wikipedia:Dŏng-nièng gĭng-dáng/10 nguŏk 16 hô̤	Template:PaginaPrincipale/Attualita/16 ottobre
Wikipedia:Dŏng-nièng gĭng-dáng/10 nguŏk 14 hô̤	Template:PaginaPrincipale/Attualita/14 ottobre
Wikipedia:Dŏng-nièng gĭng-dáng/10 nguŏk 18 hô̤	Template:PaginaPrincipale/Attualita/18 ottobre
Wikipedia:Dŏng-nièng gĭng-dáng/10 nguŏk 24 hô̤	Template:PaginaPrincipale/Attualita/24 ottobre
Wikipedia:Dŏng-nièng gĭng-dáng/10 nguŏk 3 hô̤	Template:PaginaPrincipale/Attualita/3 ottobre
Wikipedia:Dŏng-nièng gĭng-dáng/09 nguŏk 7 hô̤	Template:PaginaPrincipale/Attualita/7 settembre
分類:Săng	Categoria:Montagne
模板:IPA	Template:IPA
分類:Céng-dê-gă	Categoria:Politici
分類:Mī-ciŭ	Categoria:America
Tàng	Espettorato
分類:Gáuk-guók gì ìng-ŭk	Categoria:Persone per nazionalità
模板:Wiki-huá	Template:W
分類:Gŭng-sê̤ṳ	Categoria:Forze armate
模板:Increase	Template:Aumento
模板:Ciŭ-gĭ-biēu	Template:Tavola periodica
模板:User nl	Template:Utente nl
模板:Infobox 網站	Template:Sito web
Wikipedia:Dŏng-nièng gĭng-dáng/10 nguŏk 12 hô̤	Template:PaginaPrincipale/Attualita/12 ottobre
模板:Decrease	Template:Diminuzione
模板:User no-2	Template:Utente no-2
模板:Image label end	Template:Etichetta immagine fine
Wikipedia:Dŏng-nièng gĭng-dáng/11 nguŏk 5 hô̤	Template:PaginaPrincipale/Attualita/5 novembre
Wikipedia:Dŏng-nièng gĭng-dáng/10 nguŏk 13 hô̤	Template:PaginaPrincipale/Attualita/13 ottobre
Wikipedia:Dŏng-nièng gĭng-dáng/09 nguŏk 3 hô̤	Template:PaginaPrincipale/Attualita/3 settembre
Wikipedia:Dŏng-nièng gĭng-dáng/09 nguŏk 24 hô̤	Template:PaginaPrincipale/Attualita/24 settembre
模板:Purge	Template:Purga
模板:Lang-la	Template:Latino
分類:Cìng-gāng	Categoria:Emozioni e sentimenti
模板:Dṳ̆ng-huà Ìng-mìng Gê̤ṳng-huò-guók Hèng-céng-kṳ̆	Template:Province della Cina
模板:Userpage	Template:Pagina utente
模板:Non-free logo	Template:Marchio
模板:User	Template:Utente
Wikipedia:Dŏng-nièng gĭng-dáng/09 nguŏk 12 hô̤	Template:PaginaPrincipale/Attualita/12 settembre
Wikipedia:Dŏng-nièng gĭng-dáng/09 nguŏk 2 hô̤	Template:PaginaPrincipale/Attualita/2 settembre
Wikipedia:Dŏng-nièng gĭng-dáng/11 nguŏk 6 hô̤	Template:PaginaPrincipale/Attualita/6 novembre
Wikipedia:Dŏng-nièng gĭng-dáng/09 nguŏk 18 hô̤	Template:PaginaPrincipale/Attualita/18 settembre
Wikipedia:Dŏng-nièng gĭng-dáng/10 nguŏk 10 hô̤	Template:PaginaPrincipale/Attualita/10 ottobre
Wikipedia:Dŏng-nièng gĭng-dáng/10 nguŏk 9 hô̤	Template:PaginaPrincipale/Attualita/9 ottobre
Wikipedia:Dŏng-nièng gĭng-dáng/10 nguŏk 23 hô̤	Template:PaginaPrincipale/Attualita/23 ottobre
模板:Image label small	Template:Etichetta immagine piccola
模板:User fr-3	Template:Utente fr-3
模板:Gô-dā̤ gì guók-gă	Template:Stato storico
分類:User ja-M	Categoria:Utenti ja-M
模板:Gì-ngiê	Template:Disambigua
分類:Dièu-siēng lĭk-sṳ̄	Categoria:Storia della Corea
模板:User nan	Template:Utente zh-min-nan
模板:User nan-1	Template:Utente zh-min-nan-1
模板:Lang-grc	Template:Lang-grc
模板:AUS	Template:AUS
分類:Sĕng-ŭk	Categoria:Forme di vita
Wikipedia:Dŏng-nièng gĭng-dáng/09 nguŏk 14 hô̤	Template:PaginaPrincipale/Attualita/14 settembre
Wikipedia:Dŏng-nièng gĭng-dáng/09 nguŏk 9 hô̤	Template:PaginaPrincipale/Attualita/9 settembre
Wikipedia:Dŏng-nièng gĭng-dáng/09 nguŏk 13 hô̤	Template:PaginaPrincipale/Attualita/13 settembre
分類:User vi-3	Categoria:Utenti vi-3
模板:User la-1	Template:Utente la-1
分類:User fr	Categoria:Utenti fr
分類:User ja	Categoria:Utenti ja
分類:User la	Categoria:Utenti la
分類:User fr-3	Categoria:Utenti fr-3
分類:User it-3	Categoria:Utenti it-3
分類:User ja-3	Categoria:Utenti ja-3
分類:User fr-2	Categoria:Utenti fr-2
分類:User it-2	Categoria:Utenti it-2
分類:User ja-2	Categoria:Utenti ja-2
分類:User la-2	Categoria:Utenti la-2
分類:User ko-M	Categoria:Utenti ko-M
分類:User fr-M	Categoria:Utenti fr-M
分類:User it-M	Categoria:Utenti it-M
分類:User nl-M	Categoria:Utenti nl-M
分類:Ùng-cê	Categoria:Sistemi di scrittura
分類:Dô̤-gáu	Categoria:Taoismo
分類:Dō̤	Categoria:Isole
分類:User de	Categoria:Utenti de
分類:User de-2	Categoria:Utenti de-2
分類:User de-3	Categoria:Utenti de-3
分類:User de-M	Categoria:Utenti de-M
分類:User en-3	Categoria:Utenti en-3
分類:User en-M	Categoria:Utenti en-M
分類:User es	Categoria:Utenti es
分類:User es-1	Categoria:Utenti es-1
分類:User es-2	Categoria:Utenti es-2
分類:User es-3	Categoria:Utenti es-3
分類:User es-M	Categoria:Utenti es-M
分類:User it	Categoria:Utenti it
分類:User it-1	Categoria:Utenti it-1
分類:User ja-1	Categoria:Utenti ja-1
分類:User ko	Categoria:Utenti ko
分類:Mī-guók gì ciŭ	Categoria:Stati degli Stati Uniti d'America
分類:User ko-1	Categoria:Utenti ko-1
分類:User ko-2	Categoria:Utenti ko-2
分類:User ko-3	Categoria:Utenti ko-3
分類:User ksh	Categoria:Utenti ksh
分類:User ksh-M	Categoria:Utenti ksh-M
分類:User la-1	Categoria:Utenti la-1
Wikipedia:Dŏng-nièng gĭng-dáng/09 nguŏk 29 hô̤	Template:PaginaPrincipale/Attualita/29 settembre
分類:User la-3	Categoria:Utenti la-3
分類:User la-M	Categoria:Utenti la-M
Wikipedia:Dŏng-nièng gĭng-dáng/09 nguŏk 5 hô̤	Template:PaginaPrincipale/Attualita/5 settembre
模板:Information	Template:Informazioni file
分類:Huâng-cô̤i	Categoria:Criminalità
分類:Hāi	Categoria:Mari
Hŭng-siéng	Ventilatore
分類:Guōng-dĕ̤ng	Categoria:Guangdong
分類:Hók-gióng	Categoria:Fujian
分類:Ciék-ciĕ dông-ŭk	Categoria:Artropodi
分類:User nan	Categoria:Utenti zh-min-nan
分類:User nan-1	Categoria:Utenti zh-min-nan-1
分類:User nan-2	Categoria:Utenti zh-min-nan-2
分類:User nan-3	Categoria:Utenti zh-min-nan-3
分類:User nan-M	Categoria:Utenti zh-min-nan-M
分類:Hĭ-ciŭ guók-gă	Categoria:Stati dell'Africa
分類:Gáuk-guók gì gáu-ṳ̆k	Categoria:Istruzione per nazione
模板:User ja-2	Template:Utente ja-2
模板:User ja-3	Template:Utente ja-3
分類:User vi	Categoria:Utenti vi
分類:User vi-1	Categoria:Utenti vi-1
分類:User vi-2	Categoria:Utenti vi-2
分類:User vi-M	Categoria:Utenti vi-M
分類:Ciék-gŏng	Categoria:Zhejiang
分類:Ĭng-ngŏk-gă	Categoria:Musicisti
模板:Lang	Template:Lang
Wikipedia:Dŏng-nièng gĭng-dáng/09 nguŏk 21 hô̤	Template:PaginaPrincipale/Attualita/21 settembre
分類:Hŏk-sŭk	Categoria:Accademie e istituti di cultura
Bì-bà (ngŏk-ké)	Pipa (strumento musicale)
分類:Wikimedia gĕ̤ng-tiàng	Categoria:Progetti Wikimedia
分類:Gì-lôi	Categoria:Giochi di strategia
分類:Ò̤	Categoria:Fiumi
模板:User la-2	Template:Utente la-2
模板:User no-1	Template:Utente no-1
模板:User zh-1	Template:Utente zh-1
模板:User zh-2	Template:Utente zh-2
模板:User zh-3	Template:Utente zh-3
分類:Dâi-hàng Mìng-guók ìng-ŭk	Categoria:Sudcoreani
分類:Sôi-diēng ìng-ŭk	Categoria:Svedesi
分類:Nĭk-buōng ìng-ŭk	Categoria:Giapponesi
分類:Dài-uăng ìng-ŭk	Categoria:Taiwanesi
分類:User nl	Categoria:Utenti nl
分類:User zh-1	Categoria:Utenti zh-1
分類:User zh-3	Categoria:Utenti zh-3
分類:User zh-2	Categoria:Utenti zh-2
分類:Cāi	Categoria:Carta
分類:Ông-ò̤	Categoria:Canali artificiali
分類:Uŏk-nàng ìng-ŭk	Categoria:Vietnamiti
分類:Mìng-dièu huòng-dá̤	Categoria:Imperatori della dinastia Ming
分類:Ngò̤-lò̤-sṳ̆ ìng-ŭk	Categoria:Russi
分類:Hiŏng-gē̤ng ìng-ŭk	Categoria:Hongkonghesi
分類:Ciĕk-káik ìng-ŭk	Categoria:Cechi
分類:Tái-guók ìng-ŭk	Categoria:Thailandesi
分類:Sáng	Categoria:Cognomi
分類:Dièu-siēng Mìng-ciō-ciō-ngiê Ìng-mìng Gê̤ṳng-huò-guók	Categoria:Corea del Nord
分類:Dṳ̆ng-guók ìng-ŭk	Categoria:Cinesi
分類:Dièu-siēng	Categoria:Corea
分類:Dài-uăng	Categoria:Taiwan
分類:Dièu-siēng Mìng-ciō-ciō-ngiê Ìng-mìng Gê̤ṳng-huò-guók ìng-ŭk	Categoria:Nordcoreani
分類:Dâi-iòng-ciŭ guók-gă	Categoria:Stati dell'Oceania
分類:Báe̤k Mī-ciŭ guók-gă	Categoria:Stati dell'America settentrionale
分類:Ngṳ̀	Categoria:Pesci
分類:Cūi-guō	Categoria:Frutta
分類:Niōng-tā̤ dông-ŭk	Categoria:Molluschi
分類:Só-cê	Categoria:Sistemi di numerazione
分類:Gióng-dé̤ṳk cài-lâiu	Categoria:Materiali edilizi
分類:Dông-ŭk	Categoria:Animali
分類:Guòng-lé	Categoria:Diritti
分類:Ìng-guòng	Categoria:Diritti umani
分類:Ū-ké	Categoria:Armi
分類:Nàng Mī-ciŭ guók-gă	Categoria:Stati dell'America meridionale
分類:Gă-sĭ	Categoria:Mobili
分類:Ké-chiông	Categoria:Meteorologia
分類:Dṳ̆ng Mī-ciŭ	Categoria:America centrale
分類:Hiŏng-gē̤ng	Categoria:Hong Kong
分類:Ĭ-siòng	Categoria:Abbigliamento
分類:Cáik-nĭk	Categoria:Festival
分類:Kuàng-ciék dông-ŭk	Categoria:Anellidi
分類:Bâng	Categoria:Malattie
分類:Kiŏng-diòng dông-ŭk	Categoria:Celenterati
分類:Gùng-dō̤	Categoria:Arcipelaghi
分類:Káh-dièu-nó̤h	Categoria:Giocattoli
分類:Gă-dìng	Categoria:Famiglia
分類:Dṳ̆ng-guók huòng-dá̤	Categoria:Imperatori della Cina
分類:Nguòng-dièu huòng-dá̤	Categoria:Imperatori della dinastia Yuan
分類:Háng-dièu huòng-dá̤	Categoria:Imperatori della dinastia Han
分類:Báe̤k Mī-ciŭ	Categoria:America settentrionale
分類:Gŏ̤-chiū	Categoria:Cantanti
分類:Hù	Categoria:Laghi
分類:Só-hŏk-gă	Categoria:Matematici
模板:Infobox ngṳ̄-ngiòng	Template:Lingua
分類:Dâi-iòng-ciŭ	Categoria:Oceania
分類:Gô-dā̤ gì guók-gă	Categoria:Stati scomparsi
Vĩnh Long	Provincia di Vinh Long
Cāi-puŏi	Cartone ondulato
分類:Giông-kŏng	Categoria:Salute
分類:Sĕng-lī	Categoria:Fisiologia
Trojany	Trojany
模板:Infobox color	Template:Infobox colore
分類:Ā-ciŭ guók-gă	Categoria:Stati dell'Asia
分類:Mī-ciŭ guók-gă	Categoria:Stati dell'America
模板:User nan-2	Template:Utente zh-min-nan-2
模板:User la	Template:Utente la
分類:Huák-lŭk	Categoria:Leggi
分類:Bēng-guòng	Categoria:Diritto d'autore
分類:Biēu-cìng	Categoria:Espressioni facciali
分類:Ôi-sĕng	Categoria:Igiene
模板:Image label begin	Template:Etichetta immagine inizio
模板:Dṳ̆ng-huà Mìng-guók Hèng-céng-kṳ̆	Template:Suddivisioni di Taiwan
分類:Diêng-ké	Categoria:Apparecchi elettrici
模板:User vi	Template:Utente vi
分類:User en-1	Categoria:Utenti en-1
分類:User de-1	Categoria:Utenti de-1
Wikipedia:失效鏈接	Aiuto:Collegamenti interrotti
Liù-giù	Ryūkyū
模板:User nan-3	Template:Utente zh-min-nan-3
Hù-diĕk	Farfalla
模板:Hók-gióng	Template:Prefetture del Fujian
Chái-tàu	Raphanus sativus
模板:Ping	Template:Ping
模板:Ruby	Template:Ruby
模組:Arguments	Modulo:Arguments
特殊:最近其改變	Speciale:UltimeModifiche
模組:Citation/CS1	Modulo:Citazione
模組:Coordinates	Modulo:Coord
模組:Infobox	Modulo:Infobox
