非洲	Africa
日本	Giappone
南美洲	America Meridionale
Nò-vî	Norvegia
Sû-kak-làn	Scozia
Vî-ngì-sṳ̂	Galles
Pet Oi-ngì-làn	Irlanda del Nord
Hiûng-ngà-li	Ungheria
Sî-pân-ngà	Spagna
Mî-koet	Stati Uniti d'America
Pí-li-sṳ̀	Belgio
Lù-sêm-pó	Lussemburgo
Yî-chhiu	Universo
Thi-khiù	Terra
Sâng-miang	Vita
Ngìn-lui	Homo sapiens
George Washington	George Washington
Fûn-làn	Finlandia
Shuì-tién	Svezia
Tan-ma̍k	Danimarca
Pô-làn	Polonia
Li̍p-thâu-vón	Lituania
Yi-thai-li	Italia
Shuì-sṳ	Svizzera
O-thi-li	Austria
Hî-lia̍p	Grecia
Thú-ngí-khì	Turchia
Phù-thò-ngà	Portogallo
歐洲	Europa
亞洲	Asia
北美洲	America del Nord
南極洲	Antartide
Vì-kî Pak-khô	Wikipedia
Hò-làn	Paesi Bassi
Néu-yok-sṳ	New York
Fà-sṳ̀n-tun Kô-lùn-pí-â Thi̍t-khî	Washington
Khiu-kîm-sân	San Francisco
Pak-lìm	Berlino
Lo̍k-chhám-kî	Los Angeles
Thien-nó	Computer
Mióng-chi-mióng-lu	Internet
Barack Obama	Barack Obama
Vû-lâ-kûi	Uruguay
Lùn-tûn	Londra
Phìn-kó	Mela
Pâ-lì-sṳ	Parigi
Â-pak-lâ-hón Lìm-khén	Abraham Lincoln
Google	Google Inc.
Me̍t-sî-kô	Messico
Thai-sî-yòng	Oceano Atlantico
Thai-phìn-yòng	Oceano Pacifico
Kâ-li-fuk-nì-â	California
Pô-sṳ-tun	Boston
Fó-sên	Marte (astronomia)
Âi-set-ngò-pí-â	Etiopia
Sṳ̂-é	Panthera leo
Fap-koet	Francia
Sṳ-kie-ngî	Lingua esperanto
Kiéu-è	Canis lupus familiaris
Yîn-koet	Regno Unito
Meu-é	Felis silvestris catus
中華人民共和國	Cina
Fap-ngî	Lingua francese
Ǹg-è	Pesce
Pâ-sî	Brasile
François Hollande	François Hollande
Ngò-lò-sṳ̂	Russia
Kîn-ǹg	Cetacea
Chang-fông-hìn	Quadrato
Tô-lùn-tô	Toronto
Â-lâ-pâ-mâ	Alabama
Québec-sén	Québec (provincia)
Boeing 747	Boeing 747
Jimmy Wales	Jimmy Wales
Tet-koet	Germania
Pha̍k-ngò-lò-sṳ̂	Bielorussia
Tet-ngî	Lingua tedesca
Pên-tó	Islanda
Song-ti	Dio
Oi-sâ-nì-â	Estonia
David Cameron	David Cameron
Thú-sên	Saturno (astronomia)
Ku-thin-yi̍t Fî-kî	Aeroplano
1	1 (numero)
2	2 (numero)
3	3 (numero)
4	4 (numero)
5	5 (numero)
George W. Bush	George W. Bush
Lâ-thot-vì-â	Lettonia
Vû-khiet-làn	Ucraina
Tshia̍p-khiet	Repubblica Ceca
Sṳ̂-lo̍k-vì-nì-â	Slovenia
Lò-mâ-nì-â	Romania
Pó-kâ-li-â	Bulgaria
Lò-mâ	Roma
Mâ-khì-tun	Repubblica di Macedonia
Â-ngì-pâ-nì-â	Albania
Khiet-lò-âi-sî-â	Croazia
Pô-sṳ-nì-â lâu Het-set-kô-vì-ná	Bosnia ed Erzegovina
Â-set-pai-kiông	Azerbaigian
Set-phû-lu-sṳ̂	Cipro
Kak-lû-kit-â	Georgia
Hâ-sat-khiet-sṳ̂-thán	Kazakistan
Mí-li-thai	Malta
Mô-na̍p-kô	Principato di Monaco
Mùng-thi̍t-nui-kô-lò	Montenegro
Sṳn Mâ-li-nok	San Marino
Kú-pâ	Cuba
Eiffel Thiet-thap	Torre Eiffel
Yin-thu-nì-sî-â	Indonesia
Wolfgang Amadeus Mozart	Wolfgang Amadeus Mozart
Pi-tô-fûn	Ludwig van Beethoven
Thú-ngí-khì-ngî	Lingua turca
Nàm-fî	Sudafrica
Vû-tsṳ̂-phe̍t-khiet-sṳ̂-thán	Uzbekistan
Pô-tsṳ-nàm	Poznań
Fà-sâ	Varsavia
Súi	Acqua
Thien-sṳ	Televisione
Chṳ-li	Cile
Yâ-sû	Gesù
Súi-sên	Mercurio (astronomia)
Li̍t-sṳ́	Storia
Phìn-kó Kûng-sṳ̂	Apple
Kîm-sên	Venere (astronomia)
Ngî-ngièn	Linguaggio
Muk-sên	Giove (astronomia)
Thiên-vòng-sên	Urano (astronomia)
Hói-vòng-sên	Nettuno (astronomia)
Thiên-vùn-ho̍k	Astronomia
Sîn-kâ-po	Singapore
Khô-ho̍k	Scienza
Montréal	Montréal
Lie̍t-kî-tûn-sṳ-tên	Liechtenstein
Kiam-khiâu	Cambridge
Thi-ngi-chhṳ Sṳ-kie Thai-chan	Seconda guerra mondiale
Cologne	Colonia (Germania)
Kak-tên-nì-â	Gdynia
Sṳ̍p-chhiet-chhiâng	Stettino
Sṳ-ho̍k	Matematica
Lâ-tên-ngî	Lingua latina
Pâ-lìm	Bahrein
Â-mî-nì-â	Armenia
Set-ngì-vì-â	Serbia
Ngie̍t-khiù	Luna
Àu-thai-li-â	Australia
Vu̍t-lî-ho̍k	Fisica
Â-kîn-thìn	Argentina
Pi-lû	Perù
Sâng-vu̍t-ho̍k	Biologia
Tsêu-siên Mìn-tsú Tsú-ngi Ngìn-mìn Khiung-fò-koet	Corea del Nord
Kán-pu-chhài	Cambogia
Khiúng-liùng	Dinosauria
Yî-sṳ̂-làn-kau	Islam
Lech Wałęsa	Lech Wałęsa
Lin-é	Ruota
Lyon	Lione
Êu-chû Lièn-mèn	Unione europea
Rhône-Alpes	Rodano-Alpi
Chhiòn-khiù Chṳ̂-sín Mióng	World Wide Web
Ńg-ngìn	Donna
Khiûng-tsiâu	Banana
Fâ	Fiore
Mâ-lî-â-na̍p-hói	Fossa delle Marianne
Chû-mu̍k-lòng-mâ-fûng	Everest
Sàng-sṳ	Città
Nâ-pho-lùn yit-sṳ	Napoleone Bonaparte
Ngit-tèu	Sole
Pâ-sṳ-tet	Louis Pasteur
大洋洲	Oceania
Thai-yòng Hì	Sistema solare
Pô-lò-tit-hói	Mar Baltico
Ngâ-chhṳ	Dente
Khîn	Idrogeno
Hoi (氦)	Elio
Angela Merkel	Angela Merkel
Lî	Litio
Phì	Berillio
Si	Libro
Ngit	Giorno
Ngièn	Anno
Sṳ-ki	Secolo
Lò-tsṳ (Pô-làn)	Łódź
Khà-thok-vì-chṳ	Katowice
Ngie̍t-sû-fû	Rzeszów
Phìn	Boro
Thàn	Carbonio
Tham	Azoto
Yòng	Ossigeno
Hàng-sên	Pianeta
Yîm-ngo̍k	Musica
Rennes	Rennes
Mo̍k-sṳ̂-khô	Mosca (Russia)
Fuk	Fluoro
Yi-thai-li-ngî	Lingua italiana
Nái	Neon
Sṳn Pí-tet-páu	San Pietroburgo
Na̍p	Sodio
北	Nord
Mî	Magnesio
Lî (鋁)	Alluminio
Néu Sî-làn	Nuova Zelanda
南	Sud
Yin-thu	India
Si̍t	Silicio
Fap	Francio
Lìn	Fosforo
Thiet	Ferro
Tûng-kâ	Tonga
西	Ovest
Liù-vòng	Zolfo
東	Est
Liu̍k	Cloro
Pâ-pu-â Néu-kí-nui-â	Papua Nuova Guinea
Vî-lièn Sâ-sṳ-pí-â	William Shakespeare
Â (氬)	Argon
Kap	Potassio
Koi	Calcio (elemento chimico)
Yèn	Piombo
Mùng-kú-koet	Mongolia
Khong (鈧)	Scandio
Thai	Titanio
Genghis Khan	Gengis Khan
Fàm	Vanadio
Mien-yîn	Maine
Kok	Cromo
Mâ	Equus caballus
Thûng-vu̍t	Animalia
Sû-li-nàm	Suriname
Màng	Manganese
Pâ-lâ-kûi	Paraguay
Koi-â-nâ	Guyana
Ngi-su̍t	Arte
Lòi	Renio
Kô-lùn-pí-â	Colombia
Kû	Cobalto
Vû	Tungsteno
Ngiap (鎳)	Nichel
Fu̍t-kau	Buddhismo
Pô-li-vì-â	Bolivia
Tshṳ̀-nì-tha̍t lâu Tô-pâ-kô	Trinidad e Tobago
Chhṳ̍t-vu̍t	Plantæ
Sîn	Zinco
Néu Hàn-pu-ha	New Hampshire
Pí-â-vùi-sṳ̂-thok-khiet	Białystok
Ngà-mâi-kâ	Giamaica
Mà-sat-chû-set	Massachusetts
Drenthe-sén	Drenthe
Overijssel-sén	Overijssel
Kûa-thi-mâ-là	Guatemala
Gelderland-sén	Gheldria (provincia)
Pâ-hâ-mâ	Bahamas
Không-nái-tí-khiet-chû	Connecticut
Kiê-é	Gallus gallus domesticus
Ha-vî-yî	Hawaii
Fùng-tû-lâ-sṳ̂	Honduras
Tô-mí-nì-kâ	Dominica
Tô-mí-nì-kâ Khiung-fò-koet	Repubblica Dominicana
Kâ-chû (Thung-vu̍t)	Sus scrofa domesticus
Hói-thi	Haiti
Sat-ngì-ngá-tô	El Salvador
Yî-lóng	Iran
Yî-là-khiet	Iraq
Â-lâ-sṳ̂-kâ	Alaska
Kô-sṳ̂-tha̍t Lì-kâ	Costa Rica
Yî-set-lie̍t	Israele
Pâ-nâ-mâ	Panamá
Ya̍p-mùn	Yemen
Phiang-thu̍k	Virus (biologia)
Pô-làn-ngî	Lingua polacca
Yok-tan	Giordania
Nì-kâ-lâ-kûa	Nicaragua
Fu-lò-lî-tha̍t	Florida
Kit-ngí-kit-sṳ̂-thán	Kirghizistan
Â-li-sông-ná	Arizona
Khô-vî-thi̍t	Kuwait
Liàu-koet	Laos
Lì-pâ-nun	Libano
O-le̍t-kông	Oregon
Gi-tuk-gaau zung geh sin	Dio (cristianesimo)
Mâ-ngì-thoi-fû	Maldive
Yù-thâ	Utah
Mâ-lòi-sî-â	Malesia
Mién-thien	Birmania
Nì-pok	Nepal
Â-man	Oman
Pâ-kî-sṳ̂-thán	Pakistan
Khà-tha̍t	Qatar
Mióng-khiù	Tennis
Sâ-vû-thi Â-lâ-pak	Arabia Saudita
Sṳ̂-lî-làn-khà	Sri Lanka
Si-li-â	Siria
Kâ	Gallio (elemento chimico)
Thap-kit-khiet-sṳ̂-thán	Tagikistan
中華民國	Taiwan
YouTube	YouTube
Châ	Germanio
Thai-koet	Thailandia
Sṳ̂n	Arsenico
Thú-khû-man-sṳ̂-thán	Turkmenistan
Abakan	Abakan (città)
Sî	Selenio
Yî	Iridio
Â-lâ-pak Lièn-ha̍p Thai-kûng-koet	Emirati Arabi Uniti
Tshiù (溴)	Bromo
Pha̍k (鉑)	Platino
Ye̍t-nàm	Vietnam
Thai-hòn Mìn-koet	Corea del Sud
Khiet	Kripton
Â-fu-hon	Afghanistan
J. R. R. Tolkien	J. R. R. Tolkien
Lù	Rubidio
Kîm	Oro
Men-kâ-lâ-koet	Bangladesh
Ufa	Ufa (Russia)
Ôn-kô-lâ	Angola
Vùn-lòi	Brunei
Kúng	Mercurio (elemento chimico)
Fî-li̍t-pîn	Filippine
Thò	Tallio
Ngie-sat-khiet Ngiù-tun	Isaac Newton
Albert Einstein	Albert Einstein
Sṳ̂	Stronzio
Yet	Ittrio
Pit	Bismuto
Vòng-set	Giallo
Tsan-pí-â	Zambia
Sîn-pâ-pu-vî	Zimbabwe
北京	Pechino
Tuva Khiung-fò-koet	Tuva
Pok-tshṳ-ngá-na̍p	Botswana
Pho (釙)	Polonio
Bayern	Baviera
Baden-Württemberg	Baden-Württemberg
Ngo (砈)	Astato
Lòi-sò-thok	Lesotho
Mâ-tha̍t-kâ-sṳ̂-kâ	Madagascar
Mâ-là-vî	Malawi
Stuttgart	Stoccarda
Màu-li-thap-nì-â	Mauritania
Pô-làn-ngìn	Polacchi
Mo̍k-sông-pí-khiet	Mozambico
Na̍p-mí-pí-â	Namibia
Nai-khi̍p-li-â	Nigeria
Ko	Zirconio
Nì	Niobio
Yû-li-vû-sṳ̂ Khái-sat	Gaio Giulio Cesare
Sṳ̂-vî-sṳ-làn	Swaziland
Muk	Molibdeno
Thap	Tecnezio
Hamburg	Amburgo
Thoi-chhia	Metabolismo
Miên-yi̍t Hì-thúng	Sistema immunitario
Lièn-ha̍p-koet	Organizzazione delle Nazioni Unite
Sîm-chhong	Cuore umano
Thèu-nó	Cervello
Phì-fû	Pelle
Ló	Rodio
Làm-set	Blu
Pâ	Palladio (elemento chimico)
Ngiùn	Argento
Kak	Cadmio
Yîn	Indio
Siak	Stagno (elemento chimico)
Yu	Uranio
Thi (銻)	Antimonio
Ti	Tellurio
Pu	Plutonio
Tièn	Iodio
Nai	Nettunio
Set	Cesio (elemento chimico)
Phù	Protoattinio
Pi	Bario
Thú	Torio
Kap (鉿)	Afnio
Than (鉭)	Tantalio
Luì	Radio (elemento chimico)
Tûng	Radon
Alsace	Alsazia
Auvergne	Alvernia
Ôn-tet-là-pâng	Andhra Pradesh
Me̍t-hiet-kîn	Michigan
Burgundy	Borgogna
Aquitaine	Aquitania
Schleswig-Holstein	Schleswig-Holstein
Hâ Saxony	Bassa Sassonia
Pet Rhine-Westphalia	Renania Settentrionale-Vestfalia
Saxony	Sassonia
Yî-li-nò	Illinois
Thuringia	Turingia
Saxony-Anhalt	Sassonia-Anhalt
Pet Tha̍t-khô-thâ	Dakota del Nord
Brandenburg	Brandeburgo
Bremen-chû	Brema (stato)
Nàm Tha̍t-khô-thâ	Dakota del Sud
Mùng-thai-nâ	Montana
Fài-ngò-mìn	Wyoming
Yâ-lu-sat-lâng	Gerusalemme
Oi-tha̍t-hòt	Idaho
Fà-sṳn-tun	Washington (stato)
Lù (鑪)	Rutherfordio
Nui-fà-tha̍t	Nevada
Hàn (𨧀)	Dubnio
Hí (𨭎)	Seaborgio
Yin-thu-yòng	Oceano Indiano
Khô-sò-vok	Kosovo
Kâ-le̍t-pí-hói	Mare Caraibico
Pô (𨨏)	Bohrio
Het (𨭆)	Hassio
Phan Kî-vùn	Ban Ki-moon
Ma̍k (䥑)	Meitnerio
Khô-lò-là-tô	Colorado
Tha̍t	Darmstadtio
Siau-pâng	Fryderyk Chopin
Lùn	Roentgenio
Kô (鎶)	Copernicio
分類:Chú-yeu fûn-lui	Categoria:Categorie
Chi-kâ-kô	Chicago
Arnhem	Arnhem
Tûng-kui	Inverno
Sî-pân-ngà-ngî	Lingua spagnola
Fî-là-thiet-fî	Filadelfia (Stati Uniti d'America)
Tî-tû	Araneae
Kîm-tshièn	Denaro
Vì-kit-nì-â	Virginia
Sî Vì-kit-nì-â	Virginia Occidentale
Tshiâng-tséu	Capsicum annuum
Néu-yok-chû	New York (Stato)
Sṳ (鈰)	Cerio
Phú	Praseodimio
Lò-tet-tó	Rhode Island
Ńg	Neodimio
Khûn-chhùng	Insecta
Mâ-lî-làn	Maryland
Thi̍t-lâ-ngá	Delaware
Yû (銪)	Europio
Ngò-hài-ngò	Ohio
Vì-kit-ngì	Publio Virgilio Marone
Machiavelli	Niccolò Machiavelli
Pîn-sé-fap-nì-â	Pennsylvania
Uetersen	Uetersen
O-kú-sṳ̂-tû	Augusto
Néu Chhe̍t-sî-chû	New Jersey
Fûn-làn-ngî	Lingua finlandese
Yin-thi-ôn-na̍p	Indiana
Vì-sṳ̂-pha-siên	Vespasiano
Thù-là-chṳ̂n	Traiano
Hâ-tet-liòng	Publio Elio Traiano Adriano
Khièu-tshṳ-â	Georgia (Stati Uniti d'America)
Mâ-khù-sṳ̂ O-lie̍t-lî-vû-sṳ̂	Marco Aurelio
Zagreb	Zagabria
Tet-khiet-sat-sṳ̂	Texas
Thai-mí-ngì-na̍p-tet-pâng	Tamil Nadu
Pet Khà-lò-lòi-na̍p	Carolina del Nord
Nàm Khà-lò-lòi-na̍p	Carolina del Sud
Loire-sén	Loira
Pâ-set-lò-nâ	Barcellona
Vòng-lî	Ananas comosus
Me̍t-sî-sî-pí	Mississippi
Thièn-na̍p-sî	Tennessee
Néu Me̍t-sî-kô	Nuovo Messico
Mìn-nì-sû-tha̍t	Minnesota
Vî-sṳ̂-không-sîn	Wisconsin
Oi-hò-fà	Iowa
Nui-pu-lâ-sṳ̂-kâ	Nebraska
Khâm-sat-sṳ̂	Kansas
Yin-thi-ngî	Lingua hindi
Me̍t-sû-lî	Missouri
Lu-yi-sṳ̂-ôn-ná	Louisiana
Khén-thap-kî	Kentucky
Â-khén-set	Arkansas
Neil Armstrong	Neil Armstrong
O-khiet-lâ-hò-mâ	Oklahoma
Pet-hói	Mare del Nord
Mo̍k-sṳ̂-khô-chû	Oblast' di Mosca
Kiel	Kiel
Schwerin	Schwerin
Potsdam	Potsdam
Hanover	Hannover
Düsseldorf	Düsseldorf
Mainz	Magonza
Wiesbaden	Wiesbaden
Saarbrücken	Saarbrücken
Mu-nì-het	Monaco di Baviera
Erfurt	Erfurt
Dresden	Dresda
Kaliningrad-chû	Oblast' di Kaliningrad
Murmansk-chû	Oblast' di Murmansk
Kak-than-sṳ̂-khiet	Danzica
Fap-làn-khiet-fuk	Francoforte sul Meno
Fut-lò-tshṳ-ngá-fû	Breslavia
Làn	Lantanio
Ki (鉕)	Promezio
Sân	Samario
Â-chhè Thi̍t-phe̍t Hàng-chṳn-khî	Aceh
Nga̍t (釓)	Gadolinio
Thi̍t (鋱)	Terbio
Tit (鏑)	Disprosio
Sṳn-kîn	Bibbia
Fó	Olmio
Ngí (鉺)	Erbio
Tiû	Tulio
Yi	Itterbio
Liu	Lutezio
Hò-nui-sṳ	Hanoi
Chṳ̂n Yâ-sû Kau-fi	Vera Chiesa di Gesù
Yîn-ngî	Lingua inglese
Màn-kuk	Bangkok
Kit-lùng-po	Kuala Lumpur
Pâng-kâ Vú-lî-thung-sén	Bangka-Belitung
Thòi-pet-sṳ	Taipei
Mî (鋂)	Americio
Arkhangelsk-chû	Oblast' di Arcangelo
Khiu̍k	Curio
Thùng-hói-sṳ	Dong Hoi
Concepción	Concepción (Cile)
Pet (鉳)	Berkelio
Khà (鉲)	Californio
Mìn-kú-lû-sén	Bengkulu
Oi	Einsteinio
Fi	Fermio
Mùn	Mendelevio
Na	Nobelio
Ontario-sén	Ontario
Lò	Laurenzio
Karelia Khiung-fò-koet	Repubblica di Carelia
Końskowola	Końskowola
2002-ngièn	2002
2008-ngièn	2008
Charles de Gaulle	Charles de Gaulle
Cham-pî-sén	Jambi
Komi Khiung-fò-koet	Repubblica dei Komi
Nâm-póng-sén	Lampung
Pet Sû-mùn-tap-lia̍p-sén	Sumatra Settentrionale
Syktyvkar	Syktyvkar
Québec-sṳ	Québec (città)
Nenets Chhṳ-chhṳ-khî	Circondario autonomo dei Nenec
Liàu-nui-sén	Riau
Leningrad-chû	Oblast' di Leningrado
Pskov-chû	Oblast' di Pskov
Liàu-nui Khiùn-tó-sén	Isole Riau
Nizhny Novgorod-chû	Oblast' di Nižnij Novgorod
Nàm Sû-mùn-tap-lia̍p-sén	Sumatra Meridionale
Lò-mâ Ti-koet	Impero romano
Mì-ngiôn Kûng-sṳ̂	Microsoft
Tver-chû	Oblast' di Tver'
Khù-lû-fû	Kurów
Fa-ho̍k	Chimica
Smolensk-chû	Oblast' di Smolensk
Yaroslavl-chû	Oblast' di Jaroslavl'
Kostroma-chû	Oblast' di Kostroma
Ivanovo-chû	Oblast' di Ivanovo
Arnold Schwarzenegger	Arnold Schwarzenegger
Chiuk-khiù	Calcio (sport)
Ryazan-chû	Oblast' di Rjazan'
IPhone	IPhone
Sî Sû-mùn-tap-lia̍p-sén	Sumatra Occidentale
Tula-chû	Oblast' di Tula
IPad	IPad
Mâ-tet-lî	Madrid
Bryansk-chû	Oblast' di Brjansk
Michael Jackson	Michael Jackson
Kaluga-chû	Oblast' di Kaluga
Loire-Atlantique-sén	Loira Atlantica
Ain-sén	Ain
Allier-sén	Allier
Khâm-phì-là	Canberra
Sông Alpes-sén	Alte Alpi
Oryol-chû	Oblast' di Orël
Sit-nì	Sydney
Alpes-de-Haute-Provence-sén	Alpi dell'Alta Provenza
Liu̍k-set	Verde
Alpes-Maritimes-sén	Alpi Marittime (dipartimento)
Hâ-tet-sùn-hò	Hudson
Me̍t-ngì-pún	Melbourne
Fùng-set	Rosso
Ardèche-sén	Ardèche
Jena	Jena
Kursk-chû	Oblast' di Kursk
Ariège-sén	Ariège
Aude-sén	Aude
Aveyron-sén	Aveyron
Sîn Nàm Vî-ngì-sṳ̂-chû	Nuovo Galles del Sud
Bouches-du-Rhône-sén	Bocche del Rodano (dipartimento)
Àu-thai-li-â Sú-tû Liâng-thi	Territorio della Capitale Australiana
Cantal-sén	Cantal
Belgorod-chû	Oblast' di Belgorod
Côte-d'Or-sén	Côte-d'Or
Côtes-d'Armor-sén	Côtes-d'Armor
Drôme-sén	Drôme
Finistère-sén	Finistère
Voronezh-chû	Oblast' di Voronež
Sû-mùn-tap-lia̍p	Sumatra
Lipetsk-chû	Oblast' di Lipeck
Van-tan-sén	Banten
Chûng Cháu-ôa-sén	Giava Centrale
Fùi-sên	Cometa
Rostov-chû	Oblast' di Rostov
Tûng Cháu-ôa-sén	Giava Orientale
Ngâ-kâ-tha̍t Sú-tû Thi̍t-khî	Giacarta
Sî Cháu-ôa-sén	Giava Occidentale
Adygea Khiung-fò-koet	Adighezia
Ngit-ngiâ Thi-fông Thi̍t-khî	Yogyakarta
Gera	Gera
Maykop	Majkop
Cháu-ôa-tó	Giava
Kâ-lî-man-tân-chû	Kalimantan
Séu Sùn-thâ Khiùn-tó	Piccole Isole della Sonda
Sû-lâ-vî-sî-tó	Sulawesi
Mô-lu̍k-kâ Khiùn-tó	Molucche
Chûng Kâ-lî-man-tân-sén	Kalimantan Centrale
Tûng Kâ-lî-man-tân-sén	Kalimantan Orientale
Nàm Kâ-lî-man-tân-sén	Kalimantan Meridionale
Kâ-li-sî-â	Galizia (Spagna)
Sî Kâ-lî-man-tân-sén	Kalimantan Occidentale
Thai-ho̍k	Università
Pretoria	Pretoria
Chok-khiù	Tennistavolo
Â-sṳ̂-thù-lî-â-sṳ̂	Asturie
Wikipedia:Sandbox	Wikipedia:Pagina delle prove
Astrakhan-chû	Oblast' di Astrachan'
Kham-thap-pu-lî-â	Cantabria
Kalmykia Khiung-fò-koet	Calmucchia
Weimar	Weimar
Osasco	Osasco (San Paolo)
Â-là-kung	Aragona
Kak-là-sṳ̂-kô	Glasgow
Thùng-hói Kî-chhòng	Aeroporto di Dong Hoi
Vú-lîn-ngièn Fûng-kín Miàng-sṳn-khî	Wulingyuan
分類:Thòi-vân li̍t-sṳ́	Categoria:Storia di Taiwan
Curitiba	Curitiba
Chloë Grace Moretz	Chloë Grace Moretz
Khûng-chṳ́	Confucio
Corbin Bleu	Corbin Bleu
分類:Sṳ-ho̍k	Categoria:Matematica
分類:Ngìn-kûng ngî-ngièn	Categoria:Lingue artificiali
Pâ-lî-sén	Bali
Mî-kîm	Dollaro statunitense
Thi-chûng-hói	Mar Mediterraneo
Hông-chû-sṳ	Hangzhou
Kî-tuk-kau	Cristianesimo
Tûng Nú-sâ Tên-kâ-là-sén	Nusa Tenggara Orientale
Sî Nú-sâ Tên-kâ-là-sén	Nusa Tenggara Occidentale
Chûng Sû-lâ-vî-sî-sén	Sulawesi Centrale
Kô-lùn-tá-lo̍k-sén	Provincia di Gorontalo
Pet Sû-lâ-vî-sî-sén	Sulawesi Settentrionale
Tûng-nàm Sû-lâ-vî-sî-sén	Sulawesi Sudorientale
Nàm Sû-lâ-vî-sî-sén	Sulawesi Meridionale
Sî Sû-lâ-vî-sî-sén	Sulawesi Occidentale
Mâ-lû-kú-sén	Provincia di Maluku
Pet Mâ-lû-kú-sén	Maluku Settentrionale
Pâ-pu-â-sén	Papua (provincia indonesiana)
Sî Pâ-pu-â-sén	Papua Occidentale
Dagestan Khiung-fò-koet	Daghestan
Sú-tû	Capitale (città)
Monzón	Monzón
Phù-thò-ngà-ngî	Lingua portoghese
Ngie̍t	Mese
Mustafa Kemal Atatürk	Mustafa Kemal Atatürk
Makhachkala	Machačkala
Chechnya Khiung-fò-koet	Cecenia
Grozny	Groznyj
Almazán	Almazán
Vòng Hien-fàm	Huang Xianfan
Ingushetia Khiung-fò-koet	Inguscezia
Magas	Magas
Pet Ossetia–Alania Khiung-fò-koet	Ossezia Settentrionale-Alania
Kabardino-Balkaria Khiung-fò-koet	Cabardino-Balcaria
Tson-sa̍k	Diamante
Bill Gates	Bill Gates
Ngi̍t-ngî	Lingua giapponese
Pak-khô-chhiòn-sû	Enciclopedia
頭頁	Pagina principale
Karachay-Cherkessia Khiung-fò-koet	Karačaj-Circassia
Saratov	Saratov
Saratov-chû	Oblast' di Saratov
Orenburg-chû	Oblast' di Orenburg
Mordovia Khiung-fò-koet	Mordovia
Saransk	Saransk
Yâ-khiù	Baseball
Làm-khiù	Pallacanestro
Kirov-chû	Oblast' di Kirov
Udmurtia Khiung-fò-koet	Udmurtia
Sî-pak-li-â	Siberia
Mari El Khiung-fò-koet	Repubblica dei Mari
Yoshkar-Ola	Joškar-Ola
Stellenbosch	Stellenbosch
Sverdlovsk-chû	Oblast' di Sverdlovsk
Cape Town	Città del Capo
Chuvash Khiung-fò-koet	Ciuvascia
Durban	Durban
Cheboksary	Čeboksary
Tat-tat-sṳ̂-thán Khiung-fò-koet	Tatarstan
Penza-chû	Oblast' di Penza
Là-fî-ngì	Raffaello Sanzio
Pí-tet Lû-pún-sṳ̂	Pieter Paul Rubens
Ulyanovsk-chû	Oblast' di Ul'janovsk
Gung-gung-hi-tsaa	Autobus
Kâ-thai-lò-nì-â	Catalogna
Bashkortostan Khiung-fò-koet	Baschiria
Chelyabinsk-chû	Oblast' di Čeljabinsk
Pâ-lùn-sî-â Chhṳ-chhṳ-khî	Comunità valenzana
Khà-sṳ̂-tì-li-â lâu Lòi-ngong	Castiglia e León
Kurgan-chû	Oblast' di Kurgan
Mô Chhe̍t-tûng	Mao Tse-tung
Tyumen-chû	Oblast' di Tjumen'
Omsk-chû	Oblast' di Omsk
Thai-mí-ngì-ngî	Lingua tamil
Chet-ho̍k	Filosofia
分類:Candidates for speedy deletion	Categoria:Cancellare subito
Altai Khiung-fò-koet	Repubblica dell'Altaj
Kòng-khìm	Pianoforte
Gorno-Altaysk	Gorno-Altajsk
Kemerovo-chû	Oblast' di Kemerovo
Hebe Camargo	Hebe Camargo
Chṳ̂-pún chú-ngi	Capitalismo
Koet-kâ	Paese (area geografica)
Mìn-chhu̍k	Nazione
Khanty-Mansi Chhṳ-chhṳ-khî	Circondario autonomo degli Chanty-Mansi-Jugra
Yamalo-Nenets Chhṳ-chhṳ-khî	Circondario autonomo Jamalo-Nenec
Montpellier	Montpellier
分類:Thiên-vùn-ho̍k	Categoria:Astronomia
Khakassia Khiung-fò-koet	Chakassia
Irkutsk-chû	Oblast' di Irkutsk
Sakha Khiung-fò-koet	Sacha-Jacuzia
Khiet-lò-âi-sî-â-ngî	Lingua croata
Hon-pó	Hamburger
Buryatia Khiung-fò-koet	Buriazia
Vû-làn Vû-tet	Ulan-Udė
Amur-chû	Oblast' dell'Amur
Ngi-sṳ̍p Sṳ-ki	XX secolo
Gotha	Gotha
Dijon	Digione
Kâ-thai-lò-nì-â-ngî	Lingua catalana
Nordhausen	Nordhausen
Kit-lò-na̍p-sén	Girona
Eisenach	Eisenach
Se-pâu Sâng-vu̍t-ho̍k	Biologia cellulare
Sṳ-kie Ngiùn-hòng Si̍p-thòn	Banca Mondiale
A-la-pak Liên-mên	Lega araba
Mìn-tsú Tsú-ngi	Democrazia
Chhîn-chhèu (秦朝)	Dinastia Qin
Pet Thai-sî-yòng Kûng-yok Chû-chṳt	Organizzazione del Trattato dell'Atlantico del Nord
Chhìn Sṳ Fòng	Qin Shi Huang
Hon-chhèu	Dinastia Han
Hon Vú-ti Liù Chha̍t	Han Wudi
Sâng-vu̍t	Organismo vivente
Kiûn-chú-chṳ	Monarchia
Khiung-fò-koet	Repubblica
Yí-mô-khiù	Badminton
Ngièn-chhèu	Dinastia Yuan
Nazi Tet-koet	Germania nazista
Yù-thai-ngìn	Ebrei
Chang Fò	Zheng He
Chìn-chhèu	Dinastia Jìn
Ngí	Orecchio
Phi	Naso
Ngién	Occhio
Mûn-é	Culicidae
Mièn-yòng	Ovis aries
Lo̍k-thò	Camelus
Phú-nen thung-vu̍t	Mammalia
Ngie-kûng	Formicidae
Phûng-é	Anthophila
Hò-làn-ngî	Lingua olandese
Fà-thi̍t Thit-sṳ-nì Kûng-sṳ̂	The Walt Disney Company
Thot-yong Fu̍t-thông Fu̍t-son	DNA
Khiô	Solanum melongena
Siet	Neve
Â-pâ	Padre
Fûn	Minuto
Yù-thai Chhṳ-chhṳ-chû	Oblast' autonoma ebraica
Ngò-lò-sṳ̂-ngî	Lingua russa
Tûng-nàm-â Koet-kâ Lièn-mèn	Associazione delle Nazioni del Sud-est asiatico
Sakhalin-chû	Oblast' di Sachalin
Mien-pâu	Pane
Sṳ-kie Mo-yi Chû-chṳt	Organizzazione mondiale del commercio
漢語	Lingua cinese
Se-pâu	Cellula
Hiet-yi̍t	Sangue
Hi	Polmone
Lò-mâ-nì-â-ngî	Lingua romena
Pó-kâ-li-â-ngî	Lingua bulgara
Magadan-chû	Oblast' di Magadan
Chhṳ-yèn Khô-ho̍k	Scienze naturali
Het-chhe̍t Mìn	Akira Kurosawa
Franklin D. Roosevelt	Franklin Delano Roosevelt
Thi-khiù Khô-ho̍k	Scienze della Terra
Sa̍k-thèu	Roccia
Yùn	Nuvola
Kí-hò-ho̍k	Geometria
Tet-lu-kú-ngî	Lingua telugu
Thai-hì-chhèn	Atmosfera
Kak-lû-kit-â-ngî	Lingua georgiana
Kîn-chi-ho̍k	Economia
Pîn-kóng	Pangkal Pinang
漢字	Carattere cinese
Sî-lî-ngì Sṳ-mû	Alfabeto cirillico
Lâ-tên sṳ-mû	Alfabeto latino
Vùn-ho̍k	Letteratura
分類:Fap-koet	Categoria:Francia
分類:Yîm-ngo̍k	Categoria:Musica
分類:Vùn-ho̍k	Categoria:Letteratura
Fù-lì	Volpe
La̍p-pá	Tromba
Â-li̍t-sân-thai sâm-sṳ	Alessandro Magno
Kiûn-sṳ-thán-tên Yit-sṳ	Costantino I
Set-lû-sṳ thai-ti	Ciro II di Persia
Vùn-mìn	Civiltà
Kau-yuk	Educazione
Kâ-thìn	Famiglia
Nàm-ngìn	Uomo (genere)
Fûn-yîn	Matrimonio
Kiûn-sṳ	Militare
Kâ-pî	Caffè
Ngiù-nen	Latte
Sûn Chûng-sân	Sun Yat-sen
Â-yuk-vòng	Ashoka
香港	Hong Kong
Thai-yîn Ti-koet	Impero britannico
Sú-ngì	Seul
Kâm-nái-thit Koet-chi Kî-chhòng	Aeroporto Internazionale John F. Kennedy
上海	Shanghai
Lùn-tûn Hî-sṳ̂-lu Kî-chhòng	Aeroporto di Londra-Heathrow
Lùn-tûn Kak-vet Kî-chhòng	Aeroporto di Londra-Gatwick
Set-vì-li-â	Siviglia
Chhîn-chhèu	Dinastia Qing
Â-ngì-pâ-nì-â-ngî	Lingua albanese
Pâ-sṳ̂-khiet-ngî	Lingua basca
Â-lâ-kung-ngî	Lingua aragonese
Yîn-koet Hòng-khûng	British Airways
Â-mî-nì-â-ngî	Lingua armena
Vû-khiet-làn-ngî	Lingua ucraina
Pâ-lùn-sî-â	Valencia
Shuì-tién-ngî	Lingua svedese
Tan-ma̍k-ngî	Lingua danese
Nò-vî-ngî	Lingua norvegese
Kô-thi̍t-fu̍t-lòi-tet Vî-liâm Lòi-pu-nì-tsṳ	Gottfried Wilhelm von Leibniz
Tshia̍p-khiet-ngî	Lingua ceca
Sṳ̂-lo̍k-phat-khiet-ngî	Lingua slovacca
Sṳ̂-lo̍k-vì-nì-â-ngî	Lingua slovena
Hiûng-ngà-li-ngî	Lingua ungherese
Oi-sâ-nì-â-ngî	Lingua estone
Là-thot-vì-â-ngî	Lingua lettone
Li̍p-thâu-vón-ngî	Lingua lituana
Pha̍k-ngò-lò-sṳ̂-ngî	Lingua bielorussa
Kui-mí-thi̍t-lî Mùn-tet-lie̍t-fû	Dmitrij Ivanovič Mendeleev
Ngièn-chṳ́	Atomo
Lâ-set-fuk	Ernest Rutherford
Hî-lia̍p-ngî	Lingua greca
Oi-ngì-làn-ngî	Lingua irlandese
Pô-sṳ̂-ngî	Lingua persiana
Chûng-kau	Religione
Chêu-sién-ngî	Lingua coreana
Chhóng-sṳ-ki	Genesi
Kóng-tûng-fa	Lingua cantonese
Chhut-âi-khi̍p-ki	Libro dell'Esodo
Ye̍t-nàm-ngî	Lingua vietnamita
Pó-lò	Paolo di Tarso
Kô-mièn-ngî	Lingua khmer
Thai-ngî	Lingua thailandese
Mâ-lòi-ngî	Lingua malese
Yin-nì-ngî	Lingua indonesiana
Mùng-kú-ngî	Lingua mongola
Hâ-sat-khiet-ngî	Lingua kazaka
Vû-tsṳ̂-phe̍t-khiet-ngî	Lingua uzbeca
Thú-khù-màn-ngî	Lingua turkmena
Yù-thai-kau	Ebraismo
Hî-pak-lói-ngî	Lingua ebraica
Â-set-pai-kiông-ngî	Lingua azera
Mâ-khì-tun-ngî	Lingua macedone
Set-ngì-vì-â-ngî	Lingua serba
Set-ngì-vì-â Khiet-lò-thi-â-ngî	Lingua serbo-croata
Pô-sṳ-nì-â-ngî	Lingua bosniaca
Kâ-lî-sî-â-ngî	Lingua gallega
Vî-ngì-sṳ̂-ngî	Lingua gallese
Sû-kak-làn Koi-ngì-ngî	Lingua gaelica scozzese
Siak-khiet-kau	Sikhismo
John Maynard Keynes	John Maynard Keynes
Lufthansa Hòng-khûng	Lufthansa
Ló-chṳ́	Laozi
Kôn-chhóng	Fegato
Shìn	Rene
Thu-é	Coniglio
Sṳ̀n-kîn Ne-thúng	Sistema nervoso
Sîm-lî-ho̍k	Psicologia
Sṳt-kâ-mèu-nì	Gautama Buddha
Mâ-tên Lu-tet	Martin Lutero
Yî-kâ	Confucianesimo
Thiên-chú-kau	Chiesa cattolica
Tho-kau	Taoismo
Chit-siói	Midollo spinale
Sa̍t	Lingua (anatomia)
Yî-tshóng	Pancreas
Hèu-thèu	Laringe
Fuk-khiet-làn khiùn-tó	Isole Falkland
Vàng-kak-mo̍k	Muscolo diaframma
Lân-mî	Appendice vermiforme
Elizabeth Ngi-sṳ	Elisabetta II del Regno Unito
Thòng-chhèu	Dinastia Tang
John F. Kennedy	John Fitzgerald Kennedy
Mìn-chhèu	Dinastia Ming
Dwight D. Eisenhower	Dwight D. Eisenhower
Ronald Reagan	Ronald Reagan
Sat-là-kô-sat	Saragozza
Kîm Tsang-ngit	Kim Jong-il
Ngièn-su Chû-khì-péu	Tavola periodica degli elementi
Chû-su̍k	Sus (zoologia)
Mariano Rajoy	Mariano Rajoy
Se-khiûn	Bacteria
Phù-thò	Uva
Phûng-thòng	Miele
Vòng-theu	Glycine max
Kûng-chhàng-ho̍k	Ingegneria
Vùn-fa	Cultura
Fan-vun	Lingua sanscrita
Sùn-fàn Hì-thúng	Apparato circolatorio
Sôn	Acido
Yî-ho̍k	Medicina
Néu-Yok Sṳ-kie Mo-yi Chûng-sîm	World Trade Center
Hâ Màn-hâ-tun	Lower Manhattan
分類:Pâ-sî	Categoria:Brasile
Màn-hâ-tun	Manhattan
Ngièn-su	Elemento chimico
Kâ-suk-thu	Accelerazione
Li̍t	Forza
Kú	Tamburo
Tsṳt-liông	Massa (fisica)
Thien-yáng	Film
Kîm-su̍k	Metallo
Nùng-ngia̍p	Agricoltura
Sâng-yîm	Suono
Sṳ̀-kiên	Tempo
Mien-chit	Area
Kûng-kîn	Chilogrammo
Kûng-tshak	Metro
Miéu	Secondo
Pâu-siuk	Zea mays
Kûng-sṳ̂n	Litro
Fà-ngì-kiê	Wall Street
Tûng-nàm-â	Sud-est asiatico
Tshùng-khin	Chongqing
Thiên-tsîn	Tientsin
Vú-hon-sṳ	Wuhan
Kú Hî-lia̍p	Antica Grecia
Thomas Jefferson	Thomas Jefferson
Vùi-sṳ̂-khà	Huesca
Tychy	Tychy
El Masnou	El Masnou
Pu-lie̍t-thap-nì-ngî	Lingua bretone
Brittany	Bretagna
Lóng	Sordità
Chhi̍t-phiang	Malattia
Khien-không	Salute
Sok-lî-â	Soria
Màn-tó-ngî	Lingua mannese
Chhiâng-môi-su	Penicillina
Nantes	Nantes
Pot-thâm-fó	Tubercolosi
Mà-chiông	Mah Jong
模板:Location map Taiwan	Template:Mappa di localizzazione/TWN
Detroit	Detroit
Van-lî Tshòng-sàng	Grande muraglia cinese
Gard-sén	Gard
Gers-sén	Gers
Sông Garonne-sén	Alta Garonna
Sṳ̀n-sṳn Lò-mâ Ti-koet	Sacro Romano Impero
Ille-et-Vilaine-sén	Ille-et-Vilaine
Isère-sén	Isère
Chûng-kau Kói-kiet	Riforma protestante
Sông Loire-sén	Alta Loira
Lot-sén	Lot (dipartimento)
Lozère-sén	Lozère
Maine-et-Loire-sén	Maine e Loira
Nì-pu-kap-nì-sat ngi-sṳ	Nabucodonosor II
Mayenne-sén	Mayenne
Morbihan-sén	Morbihan
Nièvre-sén	Nièvre
Nord-sén	Nord (dipartimento)
Calais Hói-hia̍p-sén	Passo di Calais
Puy-de-Dôme-sén	Puy-de-Dôme
Sông Pyrénées-sén	Alti Pirenei
Pyrénées-Orientales-sén	Pirenei Orientali
Hâ Rhin-sén	Basso Reno
Sông Rhin-sén	Alto Reno
Saône-et-Loire-sén	Saona e Loira
Sarthe-sén	Sarthe
Sông Savoie-sén	Alta Savoia
Tarn-sén	Tarn
Tarn-et-Garonne-sén	Tarn e Garonna
Var-sén	Var (dipartimento)
Vaucluse-sén	Vaucluse
Vendée-sén	Vandea
Yonne-sén	Yonne
Yî-pí-li-â Pan-tó	Penisola iberica
Lai-kî	Litchi chinensis
Yâ-è	Cocos nucifera
Sa̍k-liù	Punica granatum
Chong-fa	Lingua zhuang
Sông-sok-pu-ngî	Lingua soraba superiore
Na̍p-ngá-thi̍t-ngî	Lingua nahuatl
Mí-nàm-kâ-pó-ngî	Lingua minangkabau
Mirandés-ngî	Lingua mirandese
Harvard Thai-ho̍k	Università di Harvard
Néu-yok Chṳn-khèn Kâu-yi-só	Borsa di New York
Lie̍t-yî-tha̍t-sén	Provincia di Lleida
Â-lâ-pak-ngî	Lingua araba
Kiú-chiu	Kyūshū
Si-koet	Shikoku
O-khiet-ngî	Lingua occitana
Nàm-fî Hò-làn-ngî	Lingua afrikaans
Lí Mìn-pok	Lee Myung-bak
Lû Vú-hién	Roh Moo-hyun
Kâ Mà-chiok	Passer domesticus
Kô-thiet	Mass Transit Railway
澳門	Macao
Suhl	Suhl
Mühlhausen	Mühlhausen/Thüringen
Sâ-thièn-khî	Distretto di Sha Tin
Fù Kím-Thàu	Hu Jintao
Si̍p Khiûn-phìn	Xi Jinping
Chhòng-kiáng-lu̍k	Giraffa camelopardalis
Phì-âi-mùng-thi̍t-ngî	Lingua piemontese
Thap-là-kô-na̍p	Tarragona
Provence-Alpes-Côte d'Azur	Provenza-Alpi-Costa Azzurra
Chhṳ̂m-chun-sṳ	Shenzhen
Kóng-tûng	Guangdong
Kóng-sî Chong-chhu̍k Chhṳ-chhṳ-khî	Guangxi
Mô-kài	Il Signore degli Anelli
Borredà	Borredà
Castellar de n'Hug	Castellar de n'Hug
Badajoz	Badajoz
Lu̍k-yì-tó-yen	Prefettura di Kagoshima
Kiok	Piede
Sit-thit	Lacertilia
Altenburg	Altenburg
Kiên	Spalla
Midi-Pyrénées	Midi-Pirenei
模板:Link FA	Template:Link V
Wikipedia:Chhâm-siòng	Wikipedia:Bar
Fu-mùng-thi̍t	Vermont
Hiû-sṳ̂-tûn	Houston
Kóng-chiu-sṳ	Canton
Chiông Kie-sa̍k	Chiang Kai-shek
Vûn Kâ-pó	Wen Jiabao
Nàm-kîn-sṳ	Nanchino
Phiang-yèn	Ospedale
Kông-sû	Jiangsu
Chet-kông-sén	Zhejiang
Thèn Séu-phìn	Deng Xiaoping
Pet-phu Calais Hói-hia̍p	Nord-Passo di Calais
Pays de la Loire	Paesi della Loira
Languedoc-Roussillon	Linguadoca-Rossiglione
Thiap-sat-lò-nì-kâ	Salonicco
西藏自治區	Regione Autonoma del Tibet
Hàng-thung Thien-fa	Telefono cellulare
Thò-niâu	Struthio camelus
Manchester	Manchester
Pu-lû-khiet-lìm	Brooklyn
Fòng-heu-khî	Queens
Liùng-yìn-sṳ	Yongin
Lòng	Canis lupus
Mâ-lòi Pan-tó	Penisola malese
Sîn-yok Sṳn-kîn	Nuovo Testamento
9	9 (numero)
Zung-gok Thaai-liuk	Cina continentale
Het-liùng-kông	Heilongjiang
Mâ Yîn-kiú	Ma Ying-jeou
Piên-fò-sṳ	Biên Hòa
Hiông-kóng-tó	Hong Kong (isola)
Ngà-tsông-sṳ	Nha Trang
Podolsk	Podol'sk
Pô-tô Lì-kok Thu̍k-li̍p-tóng	Partito Indipendentista Portoricano
Lì-è	Equus asinus
Si-chhôn-sén	Sichuan
Khiu-yok Sṳn-kîn	Antico Testamento
Sṳn-tan-chiet	Natale
Lò-màn Ngî-chhu̍k	Lingue romanze
Sâm-kok-hìn	Triangolo
Steve Jobs	Steve Jobs
Yin-Êu Ngî-ne	Lingue indoeuropee
Breinigerberg	Breinigerberg
Lo-fú	Panthera tigris
Fù-ôn Khà-lo̍k-sṳ̂ Yit-sṳ	Juan Carlos I di Spagna
Súi-ngièn-sṳ	Suwon
Sâm-sên Si̍p-thòn	Samsung
Louis Couturat	Louis Couturat
Thai-thièn Kóng-vet-sṳ	Daejeon
Kîn-ki-tho	Gyeonggi
Sṳ̂-khâm-tit-nâ-vì-â	Scandinavia
Fu̍k-fa̍t-chiet	Pasqua
Thien-nó Khô-ho̍k	Informatica
Koet-chi Yîm-phiêu	Alfabeto fonetico internazionale
Hò-pet	Hebei
Phú-lìm-sṳ̂-tun Thai-ho̍k	Università di Princeton
Fôn-hìn-muk	Ciconiiformes
Chhṳ̀n Súi-pién	Chen Shui-bian
台灣	Isola di Formosa
Chṳ-fi-hîn Sú-kî	Smartphone
Sa̍k-yù	Petrolio
Hài-è	Scarpa
Ngiùn-hòng	Banca
Ngièn-lun Chhṳ-yù	Libertà di parola
Oi-ngì-làn	Irlanda (isola)
Cheshire	Cheshire
Cumbria	Cumbria
Lancashire	Lancashire
Northumberland	Northumberland
Tyne and Wear	Tyne and Wear
County Durham	Durham (contea)
Pet Yorkshire	North Yorkshire
Lincolnshire	Lincolnshire
Nottinghamshire	Nottinghamshire
Derbyshire	Derbyshire
Merseyside	Merseyside
Leicestershire	Leicestershire
Rutland	Rutland
Lû-sùn	Lu Xun
Northamptonshire	Northamptonshire
Devon	Devon
Oxfordshire	Oxfordshire
Wiltshire	Wiltshire
Hampshire	Hampshire
Buckinghamshire	Buckinghamshire
Surrey	Surrey
West Sussex	West Sussex
East Sussex	East Sussex
Kent	Kent
Thai Lùn-tûn	Greater London
7	7 (numero)
8	8 (numero)
Lu̍k-é	Cervidae
Pên	Ghiaccio
Chú ke Khì-tó-vùn	Padre nostro
Ngìn-lui-ho̍k	Antropologia
Fùng-hói	Mar Rosso
Oi-tên-páu	Edimburgo
Pha̍k-set	Bianco
Marseille	Marsiglia
Thai-chhûng-thèu	Allium cepa
6	6 (numero)
Kôn-fông ngî-ngièn	Lingua ufficiale
Kháu-kú-ho̍k	Archeologia
George H. W. Bush	George H. W. Bush
Pâ-ngì-kòn pan-tó	Penisola balcanica
Dmitry Medvedev	Dmitrij Anatol'evič Medvedev
Entrena	Entrena
Sîn-kau	Protestantesimo
Selena	Selena
Mî-koet Thai-khûng Chúng-shu	NASA
Thai Put-lie̍t-tiên-tó	Gran Bretagna
Pâ-le̍t-sṳ̂-thán	Palestina
10	10 (numero)
Lila Downs	Lila Downs
Lia̍p-pau	Acinonyx jubatus
Cleveland (Yîn-koet)	Cleveland (Regno Unito)
Liverpool	Liverpool
Bremen	Brema
Sîn Nò-vî-ngî	Nynorsk
Meu-thèu-tiâu	Strigiformes
Sṳ̀	Ora
Fap-lò-ngî	Lingua faroese
Kîm-eu-sṳ	Cà Mau
Meu-khô	Felidae
Koet-chi Thai-khûng Chhàm	Stazione Spaziale Internazionale
Tà-la-sṳ	Da Lat
Tat-tat-ngî	Lingua tatara
Tshûng-liông	Forza peso
Tsûng-su	Phoenix dactylifera
Fan-tshiet-sṳ	Phan Thiết
Sî Fut-lî-sî-ngî	Lingua frisone
Séu Vòng-chṳ́	Il piccolo principe
Phiàng-fông kûng-tshak	Metro quadrato
Fó-yam-chhùng	Lampyridae
Li̍p-fông kûng-tshak	Metro cubo
Fàn-chiet-thûng-vu̍t-mùn	Annelida
Chhú-khô	Muridae
Lû-sêm-nì-â-ngî	Lingua rutena
Ede (Hò-làn)	Ede (Paesi Bassi)
Fú-kîn	Orcinus orca
Sâ-thi̍t-fut-lî-sî-ngî	Dialetto frisone orientale
Liû-khiù-koet	Regno delle Ryūkyū
Pet-fut-lî-sî-â-ngî	Dialetto frisone settentrionale
Â-mê-ha̍p-lâ-ngî	Lingua amarica
蝠婆	Chiroptera
Tarnobrzeg	Tarnobrzeg
Vòng Ti	Huang Di
Tiau-ǹg-thòi Lie̍t-yí	Isole Senkaku
Khiung-fò-tóng (Mî-koet)	Partito Repubblicano (Stati Uniti d'America)
Â-sṳ̂-thù-lî-â-sṳ̂-ngî	Lingua asturiana
O-thi-li Pâ-vî-li-â-ngî	Lingua bavarese
Mìn-chú-tóng (Mî-koet)	Partito Democratico (Stati Uniti d'America)
Sàng-tû-sṳ	Chengdu
Âi-sṳ̂-thi̍t-lùi-mâ-thu-lâ-ngî	Lingua estremegna
Séu-su mìn-chhu̍k	Minoranza
Pô-lòi-kú	Pleiku
Â-ha̍p-sṳ̂-vòng	Acaz
Chûng-chû-sṳ	Chungju
Yî-liàu Ví-sâng	Assistenza sanitaria
Khiet-là-khô-fû	Cracovia
臺灣省	Provincia di Taiwan
Pet-kîn Sú-tû Koet-chi Kî-chhòng	Aeroporto di Pechino-Capitale
Sîn-kâ-po Hòng-khûng Kûng-sṳ̂	Singapore Airlines
Thien-nó Thôn-chhèn Só-mèu	Tomografia computerizzata
Vî-nî-sṳ̂-ngî	Lingua veneta
Vû-lòi-khî	Wulai
Koet-li̍p Thòi-vân Thai-ho̍k	Università Nazionale di Taiwan
Vì-phú-sêm-ngî	Lingua vepsa
Fu̍t-lò-ngî	Lingua võro
Pân-mâ	Zebra
Valery Leontiev	Valerij Jakovlevič Leont'ev
Khô-sî-kâ-ngî	Lingua corsa
Buryat-ngî	Lingua buriata
Sùn-tho-chûng	Metodismo
Suk-vú-ngî	Lingua cebuana
Chavacano-ngî	Lingua zamboangueña
Tha̍t-lò-phî-thû Ngî-hì	Lingue dravidiche
客家語	Lingua hakka
Pet-nèn-sṳ	Bắc Ninh
Liùng-chhôn-sṳ	Long Xuyen
Mî-tshiu-sṳ	Mỹ Tho
Fut-liù-li-ngî	Lingua friulana
Pâng-mî-tsuk	Buôn Ma Thuột
Kàm-ngî	Lingua gan
Pok-vu̍t-kón	Museo
Yin-thu Yî-lóng Ngî-chhu̍k	Lingue indoiraniche
Thai-yùng-meu	Ailuropoda melanoleuca
Kalmyk-ngî	Lingua calmucca
Mân-ngî	Lingua mancese
Kû-li̍p ngî-ngièn	Lingua isolata
Kit-là-kî-ngî	Lingua gilaki
Khà-sû-pí-ngî	Lingua casciuba
Karachay-Balkar-ngî	Lingua caraciai-balcara
Lùn-pâ-tí-ngî	Lingua lombarda
Sú	Mano
Thu fú	Du Fu
O-lî-â-ngî	Lingua oriya
Ngìn-khiéu	Popolazione
Nò-man-thi-ngî	Lingua normanna
Nèn-phìn-sṳ	Ninh Bình
Pet-sat-mí-ngî	Lingua sami settentrionale
O-set-thôi-ngî	Lingua osseta
Sî-sî-lî-ngî	Lingua siciliana
Sat-tên-nî-â-ngî	Lingua sarda
Nì-ngá-ngì-ngî	Lingua Nepal Bhasa
Valparaíso	Valparaíso
Yên-yèn	Attore
Thap-kâ-lo̍k-ngî	Lingua tagalog
Thùng	Bronzo
Vlaams-ngî	Lingua fiamminga
Fà-liùng-ngî	Lingua vallone
Sú-ngî	Lingua dei segni
Międzyrzec Podlaski	Międzyrzec Podlaski
Phiêu-chún Chhông-ngî	Lingua tibetana
Ngá-shuì-ngá-shuì-ngî	Lingua waray-waray
Yì-ku-tshu̍k	Yugur
N̂g-ngî	Lingua wu
Woodrow Wilson	Thomas Woodrow Wilson
Fu̍t-sân-sṳ	Foshan
Ngiù-chîn Thai-ho̍k	Università di Oxford
Sú-tsṳ́	Dito
Sṳ̍p-thiàu Kie-min	Dieci comandamenti
Yok-hon-nì-sṳ̂-páu	Johannesburg
Kî-tuk Kau-fi	Chiesa
Pau-é	Panthera pardus
Sîn-kiông	Xinjiang
Muk-kôa	Carica papaya
Pu-lî-sṳ̂-pân	Brisbane
Â-mî-ngî	Lingua amis
Vî-liâm Lùn-khìm	Wilhelm Conrad Röntgen
Chû-chhèu	Dinastia Zhou
Ido-ngî	Lingua ido
Brad Pitt	Brad Pitt
Pa̍k-kiûng	Casa Bianca
Tha̍t-mâ-thai-ngî	Lingua dalmatica
Tat-tat-chhu̍k	Tatari
Thai-fán-sṳ	Osaka
Kiam-khiâu Thai-ho̍k	Università di Cambridge
Kûng-khín	Ettaro
Sé-lî	Battesimo
Pông-hâ	Asma
Chuk	Bambuseae
Hiligaynon-ngî	Lingua hiligaynon
Fù Tsṳ-mìn	Ho Chi Minh
Thièn-piên-fú	Dien Bien Phu
Khûn-sṳ-làn-chû	Queensland
Kûi-yìn-sṳ	Qui Nhon
Mìn-nì-â-pô-li-sṳ̂	Minneapolis
Li̍t-ka-sṳ	Rach Gia
Li-kú-lî-â-ngî	Lingua ligure
Phô-lò-chû	Borneo
Khà-phién-phién-kâm-ngî	Lingua kapampangan
Vù-fâ-kó	Ficus carica
Sun-fa-sṳ	Huế
Tshòng-thu	Lunghezza
Sṳ̂-chhù-chṳ̂-lu	Via della seta
Mô-li-ngî	Lingua māori
Mên-tûng-ngî	Min dong
Tô-se-pâu sâng-vu̍t	Organismo pluricellulare
Mên-nàm-ngî	Lingua min nan
Tshiên-ngièn	Millennio
Ho̍k-miàng	Nomenclatura binomiale
Vì-tô-li-â-chû	Victoria (Australia)
Chong-chhu̍k	Zhuang
Aung San Suu Kyi翁山蘇姬	Aung San Suu Kyi
Tshèu-chû-fa	Dialetto teochew
Yok-hon-fuk-yîm	Vangelo secondo Giovanni
William Vòng-chṳ́	William, duca di Cambridge
Chhṳ̀n Kóng-sâng	Jackie Chan
12	12 (numero)
Vok-là-phú-khiet-ngî	Volapük
Toshiro Mifune	Toshirō Mifune
Kám-lám-su	Olea europaea
Só-lò-mùn-vòng	Salomone
O-khiet-làn	Auckland
Chhṳ̍t-sien	Retta
11	11 (numero)
13	13 (numero)
Sûn-chṳ́	Sun Tzu
Sṳn-lìn	Spirito Santo
Lû-pu-lìm	Lublino
Thì-thèu	Arachis hypogaea
100	100 (numero)
Tshit-thèu	Ginocchio
Tô-piên-hìn	Poligono
Nàm Chûng-koet Hói	Mar Cinese Meridionale
Campora San Giovanni	Campora San Giovanni
Pien-set-liùng	Chamaeleonidae
Bloemfontein	Bloemfontein
Ngiam-set-thí	Cromosoma
O-khiet-làn Vùn-fap Ho̍k-káu	Auckland Grammar School
Ngióng-kông	Yangon
Ma̍k-tông-lò Kûng-sṳ̂	McDonald's
1000000	Milione
Meu-miàng-sṳ	Maoming
Liú-chiu-sṳ	Liuzhou
Pet-pan-khiù	Emisfero boreale
Ló-chhú	Mus (genere)
Thí-tsit	Volume
Het-tsṳ̂	Hertz
Pak-pân-khiet	Burbank (Contea di Los Angeles)
Sien-lia̍p-thí	Mitocondrio
Yî-sên	Medico
Ki-sa̍k-chhṳn	Stonehenge
Chúng-thí Kîn-chi-ho̍k	Macroeconomia
Ágreda	Ágreda
Lu-kâ-fuk-yîm	Vangelo secondo Luca
Sîn Kí-nui-â	Nuova Guinea
Sṳ́-thù-hàng-chhon	Atti degli Apostoli
Mô-hái	Brachyura
PH	PH
Khì-tó	Preghiera
Ôn-fui-sén	Anhui
Chûng-chhîn Pet-tho	Chungcheong Settentrionale
Chûng-chhîn Nàm-tho	Chungcheong Meridionale
Kông-ngièn-tho (Hôn-koet)	Gangwon
Nui Mùng-kú	Mongolia Interna
Kîm Ngit-sṳ̀n	Kim Il-sung
Chhái-na̍p Koet-chi Phú-chhu Ngî-ngièn Thoi-péu-thòn	Delegazione per l'adozione di una lingua ausiliaria internazionale
Pí-tet-kô-sṳ̍p	Bydgoszcz
Nottingham	Nottingham
Thai-ví-vòng	Davide
Li-vi-ki	Levitico
Sṳ̂-thán-fuk Thai-ho̍k	Università di Stanford
Fuk-kian	Fujian
Kûng-khiet	Grammo
Mùng-kú-tshu̍k	Mongoli
Khí-sṳ-liu̍k	Apocalisse di Giovanni
Kong-lîn-sṳ	Gangneung
Kiê-liùng-sṳ	Gyeryong
Kô-yòng-sṳ	Goyang
Kûng-chû-sṳ	Gongju
Kó-chhôn-sṳ	Gwacheon
Kông-mìn-sṳ	Gwangmyeong
Kóng-chû-sṳ (Hôn-koet)	Gwangju (Gyeonggi)
Kiú-lî-sṳ	Guri
Kiûn-phú-sṳ	Gunpo
Kîm-phú-sṳ	Gimpo
Nàm-yòng-chû-sṳ	Namyangju
Lun-sân-sṳ	Nonsan
Thông-chîn-sṳ (Hôn-koet)	Dangjin
Tûng-theu-chhôn-sṳ	Dongducheon
Tûng-hói-sṳ (Hôn-koet)	Donghae
Pó-nèn-sṳ	Boryeong
Fu-chhôn-sṳ	Bucheon
Sâm-chit-sṳ	Samcheok
Shuì-sân-sṳ	Seosan
Sàng-nàm-sṳ	Seongnam
Suk-chhó-sṳ	Sokcho
Sṳ́-hîn-sṳ	Siheung
Ngà-sân-sṳ	Asan
Ôn-sân-sṳ	Ansan (Corea del Sud)
Ôn-sàng-sṳ (Hôn-koet)	Anseong
Ôn-yông-sṳ	Anyang (Corea del Sud)
Yòng-chû-sṳ	Yangju
Vû-sân-sṳ	Osan
Ngièn-chû-sṳ	Wonju
Ngi-vòng-sṳ	Uiwang
Ngi-chṳn-fú-sṳ	Uijeongbu
Li-chhôn-sṳ (Hôn-koet)	Icheon
Thî-chhôn-sṳ	Jecheon
Thiên-ôn-sṳ	Cheonan
Chhîn-chû-sṳ	Cheongju
Chhûn-chhôn-sṳ	Chuncheon
Thai-pha̍k-sṳ	Taebaek
Po-chû-sṳ	Paju
Phìn-tshe̍t-sṳ	Pyeongtaek
Phàu-chhôn-sṳ	Pocheon
Hò-nàm-sṳ	Hanam
Fà-sàng-sṳ	Hwaseong
Buckingham Kiûng	Buckingham Palace
Hói-nàm	Hainan
Yén-tûng	Estremo Oriente
Ngiên-kiu	Ricerca scientifica
Kâm-suk	Gansu
Pha̍k Se-pâu	Leucocita
York	York
Tsiú	Gomito
Sṳ̂n-min-ki	Deuteronomio
Sû-chû-sṳ	Suzhou
Vûn-chû-sṳ	Wenzhou
Windsor Sàng-páu	Castello di Windsor
Hòn-chhu̍k	Han
Nèn-pô-sṳ	Ningbo
Tet-koet-ngìn	Tedeschi
Ko-men	Allergia
Fù-khì	Hirudinea
Kîm-yùng	Finanza
1000	1000 (numero)
Mìn-su-ki	Numeri (Bibbia)
Liu̍k Khiet-vùn	Kevin Michael Rudd
Ngo̍k-ǹg	Crocodylidae
Yùn-nàm	Yunnan
Vû-â	Corvus
Plymouth	Plymouth
Sân-tûng	Shandong
Pí	Braccio
Derby-sṳ	Derby (Regno Unito)
Thàn-khîn Fa-ha̍p-vu̍t	Idrocarburi
Hò-nàm	Henan
Montehermoso	Montehermoso
Liâu-nèn	Liaoning
El Cid	El Cid
Jim Morrison	Jim Morrison
Thòi-vân Thò-yèn Koet-chi Kî-chhòng	Aeroporto di Taipei-Taoyuan
Kit-lìm	Jilin (provincia)
Fù-nàm	Hunan
Chhiâng-hói	Qinghai
Vì-ngâ-ngì-tshu̍k	Uiguri
Rhône-sén	Rodano (dipartimento)
Koet-kâ Kûng-yèn	Parco nazionale
Pâ-lì Charles-de-Gaulle Koet-chi Kî-chhòng	Aeroporto di Parigi Charles de Gaulle
Chṳ̂-sán	Cespite
O-le̍t-liòng	Aureliano
Fù-pet	Hubei
Sân-sî	Shanxi
Hòng-khûng Kûng-sṳ̂	Compagnia aerea
Hò-khiéu-vân	Estuario
Chûng-set	Marrone
Kui-chû	Guizhou
Berkelland	Berkelland
Chûng-khi Sṳ̀n-kîn Ne-thúng	Sistema nervoso centrale
Yî-fut-só	Efeso
Ôn-tha̍t-màn Hói	Mare delle Andamane
Yok-sû-â-ki	Libro di Giosuè
Sî-pet Yîn-kak-làn	Nord Ovest (Inghilterra)
Shám-sî-sén	Shaanxi
Tûng-pet Yîn-kak-làn	Nord Est (Inghilterra)
Tûng Midlands	Midlands Orientali
Tûng Yîn-kak-làn	Est dell'Inghilterra
Tûng-nàm Yîn-kak-làn	Sud Est (Inghilterra)
Sî-nàm Yîn-kak-làn	Sud Ovest (Inghilterra)
模板:Commonscat	Template:Commonscat
Sî Midlands	Midlands Occidentali (regione)
Yorkshire lâu Humber	Yorkshire e Humber
Kòn Se-pâu	Cellula staminale
Lò-mâ-sû	Lettera ai Romani
Mâ-liuk-kap Hói-hia̍p	Stretto di Malacca
Yù-thai Vòng-koet	Regno di Giuda
Mî-koet Pha̍k-ngìn	Bianchi americani
Fî-yí Mî-koet Het-ngìn	Afroamericano
Mà-sat-chû-set Lî-kûng Ho̍k-yen	Massachusetts Institute of Technology
Pô-sṳ-tun Thai-ho̍k	Università di Boston
Yâ-lû Thai-ho̍k	Università di Yale
Lû-khái-ngî	Lingua rukai
Nàm-pet-chêu	Dinastie del Nord e del Sud
Fûn-lî	Nozze
Pan Chúng-thúng-chṳ	Repubblica semipresidenziale
Kâ-phìn-khiùn	Gapyeong
Kô-sàng-khiùn (Hôn-koet)	Goseong (Gangwon)
Fâi-sân-khiùn	Goesan
Kím-sân-khiùn	Geumsan
Tan-yòng-khiùn (Hôn-koet)	Danyang
Po-ên-khiùn	Boeun
Fù-yì-khiùn	Buyeo (contea)
Sû-chhôn-khiùn	Seocheon
Yòng-khiéu-khiùn	Yanggu (Corea del Sud)
Siong-yòng-khiùn	Yangyang
Yòng-phìn-khiùn	Yangpyeong
Lî-chû-sṳ	Yeoju
Liên-chhôn-khiùn	Yeoncheon
Yún-thùng-khiùn	Yeongdong
Nèn-ye̍t-khiùn	Yeongwol
Lî-sân-khiùn	Yesan
Vok-chhôn-khiùn	Okcheon
Yîm-sàng-khiùn	Eumseong
Lîn-thài-khiùn	Inje
Tsin-san-khiùn	Jeongseon
Chên-phiàng-khiùn	Jeungpyeong
Chṳ́n-chhôn-khiùn	Jincheon
Thiet-ngièn-khiùn	Cheorwon
Chhiâng-yòng-khiùn	Cheongyang
Thai-ôn-khiùn	Taean
Fùng-sàng-khiùn	Hongseong
Fùng-chhôn-khiùn	Hongcheon
Fà-chhôn-khiùn	Hwacheon
Vàng-sàng-khiùn	Hoengseong
Ên-phìn-sṳ	Eunpyeong-gu
Fî-li̍p-pí-sû	Lettera ai Filippesi
Thiên-koet Pat-fuk	Beatitudini evangeliche
Mî-koet Lièn-pâng Chún-phi Ne-thúng	Federal Reserve System
Kúai-é	Anura
Hâ Sî-lî-sî-â-sén	Voivodato della Bassa Slesia
Khù-â-vì - Pô-mî-là-nì-â-sén	Voivodato della Cuiavia-Pomerania
Lû-pu-lìm-sén	Voivodato di Lublino
Lû-pu-sṳ̂-khà-sén	Voivodato di Lubusz
Lò-tsṳ-sén	Voivodato di Łódź
Séu Pô-làn-sén	Voivodato della Piccola Polonia
Mâ-tsó-fû-sá-sén	Voivodato della Masovia
O-pô-lòi-sén	Voivodato di Opole
Khak-ngì-pâ-yèn-sân-sén	Voivodato della Precarpazia
Pô-tet-là-chhia-sén	Voivodato della Podlachia
Pô-mî-là-nì-â-sén	Voivodato della Pomerania
Sî-lî-sî-â-sén	Voivodato della Slesia
Sṳn-sṳ̍p-sṳ-sén	Voivodato della Santacroce
Sî Pô-mî-là-nì-â-sén	Voivodato della Pomerania Occidentale
Pâ-lùn-sî-â-sén	Provincia di Valencia
Sat-là-kô-sat-sén	Provincia di Saragozza
Vùi-sṳ̂-khà-sén	Provincia di Huesca
Sok-lî-â-sén	Provincia di Soria
Hien-thoi Khì-chhâ	Hyundai Motor Company
Kîm Tsang-ên	Kim Jong-un
Pu-nùng-ngî	Lingua bunun
Kông-sî	Jiangxi
Wernher von Braun	Wernher von Braun
Nèn-ha	Ningsia
Lí Hién-liùng	Lee Hsien Loong
Kîm-fà-sṳ	Jinhua
Thòi-chû-sṳ	Taizhou (Zhejiang)
Phòng-châ-phú-ngî	Lingua punjabi
Phú-sṳ̍p-thok-ngî	Lingua pashtu
Yâ-chû	Sus scrofa
Chû-hói-sṳ	Zhuhai
Sân-thèu-sṳ	Shantou
Shâu-kûan-sṳ	Shaoguan
Kông-mùn-sṳ	Jiangmen
Chhám-kông-sṳ	Zhanjiang
Shàu-khin-sṳ	Zhaoqing
Fi-chiu-sṳ	Huizhou
Mòi-chiu-sṳ	Meizhou
San-mî-sṳ	Shanwei
Hò-ngièn-sṳ	Heyuan
Yòng-kông-sṳ	Yangjiang
Chhîn-yén-sṳ	Qingyuan
Tûng-kôn-sṳ	Dongguan
Chûng-sân-sṳ	Zhongshan
Chhèu-chiu-sṳ	Chaozhou
Thiên-tén-yen	Contea di Tiandeng
Liùng-chiu-yen	Contea di Longzhou
Nèn-mìn-yen	Contea di Ningming
Thai-sîn-yen	Contea di Daxin
Mâ-liuk-kap-sṳ	Malacca (Malesia)
Khiâu-chhṳ-sṳ	George Town (Malesia)
IPhone 5	IPhone 5
Mèu-li̍t-yen	Contea di Miaoli
Sṳn-chhôn-lî	Eucaristia
Fuk-chiu-sṳ	Fuzhou
Nàm-phìn-sṳ	Nanping
Phû-thièn-sṳ	Putian
Sâm-mìn-sṳ	Sanming
Tshièn-chiu-sṳ	Quanzhou
Hà-mûn-sṳ	Xiamen
Chông-chiu-sṳ	Zhangzhou
Liùng-ngâm-sṳ	Longyan
Nèn-tet-sṳ	Ningde
Sî-pak-li-â Fú	Panthera tigris altaica
Thiên-ngô-yen	Contea di Tian'e
Nàm-tan-yen	Contea di Nandan
Fung-sân-yen	Contea di Fengshan
Tûng-làn-yen	Contea di Donglan
Buren	Buren
Sîn-chuk-yen	Contea di Hsinchu
Nó	Encefalo
Thông Ngiâ-mong	Johann Adam Schall von Bell
Yáng-chhiong Chín-thôn-ho̍k	Radiologia
Rumia	Rumia
Kluczbork	Kluczbork
La̍p-tsuk	Candela (illuminazione)
Hiet-chiong	Plasma (biologia)
Southampton	Southampton
Lu-tet-ki	Libro di Rut
Hâ-sat-khiet-chhu̍k	Kazaki
Yòng-mî	Anisoptera
Chit-fûn-ho̍k	Integrale
Kô-lìm-tô-chhièn-sû	Prima lettera ai Corinzi
Sî-pân-ngà Ti-koet	Impero spagnolo
Sṳ-sṳ̂-ki	Libro dei Giudici
Po-lîn-chhòi	Spinacia oleracea
Pâ-set-lò-nâ-sén	Provincia di Barcellona
Nàm-thèu-yen	Contea di Nantou
Liuk-piên-hìn	Esagono
Thòi-pet 101	Taipei 101
Lùn-tûn Thap-khiâu	Tower Bridge
Luì-kûng	Tuono
Siù-li Yún-kòn-sien-chhùng	Caenorhabditis elegans
O-pô-lòi	Opole
Sopot	Sopot
Â-sṳ̂-thù-lî-â-sṳ̂-sén Chhṳ̍t-hot-sṳ	Lista dei comuni della provincia delle Asturie
Kám-lám-yù	Olio di oliva
Chim-sin-fi	Battismo
Set-vì-li-â-sén	Provincia di Siviglia
Thap-là-kô-na̍p-sén	Provincia di Tarragona
Provence-sén	Provenza
Kî-hài Kûng-chhàng	Ingegneria meccanica
Apeldoorn	Apeldoorn
Lìm-pó-ngî	Lingua limburghese
Khái-ngì-chhái	Kielce
Bytom	Bytom
Ôn-sit-ngit	Shabbat
Khìm-sṳ̂-thok-khok-ngá	Częstochowa
Zabrze	Zabrze
Ôn-sit-ngit-fi	Chiesa cristiana avventista del settimo giorno
Jean Michel Jarre	Jean Michel Jarre
Thai Pô-làn Thi-khî Kô-yî-fû	Gorzów Wielkopolski
Là-tô-mê	Radom
Lo̍k-chham-ki-yen	Contea di Los Angeles
Słupsk	Słupsk
Sosnowiec	Sosnowiec
Gliwice	Gliwice
Yo̍k-sṳ̂	Farmacista
Hi-kôn Yì-chhṳ̍t	Trapianto
Bielsko-Biała	Bielsko-Biała
Rybnik	Rybnik
Tân-fu̍t Se-pâu	Monocita
Mâ-khó-fuk-yîm	Vangelo secondo Marco
Ruda Śląska	Ruda Śląska
Yok-thán-vòng	Ioatam
Thò-yèn-yen	Contea di Taoyuan
Nò-mí	Riso glutinoso
Kîn-tû-fú	Prefettura di Kyoto
Kau-su	Professore
Thai-fán-fú	Prefettura di Osaka
Fuk-kông-yen	Prefettura di Fukuoka
Oi-yèn-yen	Prefettura di Ehime
Kô-lìm-tô-heu-sû	Seconda lettera ai Corinzi
Khien-mî	Culturismo
Port Elizabeth	Port Elizabeth
Kimberley (Nàm-fî)	Kimberley (Sudafrica)
Yok-sâ-fap-vòng	Giosafat
Thòi-vân Hói-hia̍p	Stretto di Formosa
Sî Khôi-phú-sén	Provincia del Capo Occidentale
Yamaguchi-yen	Prefettura di Yamaguchi
Khiâu-chhṳ Sâm-sṳ	Giorgio III del Regno Unito
Chûng-koet Thi-fông	Chūgoku
Mî-koet Thu̍k-li̍p Siên-ngièn	Dichiarazione di indipendenza degli Stati Uniti d'America
Sâm-tshûng-yen	Prefettura di Mie
Yù-mu̍k mìn-chhu̍k	Popoli nomadi
Hiông-pak-su	Cedrus
Hî-pak-lòi-sû	Lettera agli Ebrei
Kâ-lâ-thai-sû	Lettera ai Galati
Màn-é	Anguilliformes
Sông-chhèu	Dinastia Shang
Thai-thúi	Coscia
Pîn-khù-yen	Prefettura di Hyōgo
Kiûng-khì-yen	Prefettura di Miyazaki
Yùng-pún-yen	Prefettura di Kumamoto
Stamford Raffles	Thomas Stamford Raffles
Sha̍m-é	Cicadidae
Tûng Khôi-phú-sén	Provincia del Capo Orientale
Fap-koet Hòng-khûng	Air France
Kô-lò-sî-sû	Lettera ai Colossesi
Ngâ-kok-sû	Lettera di Giacomo
Yok-hon-yit-sû	Prima lettera di Giovanni
Fî-li-mùn-sû	Lettera a Filemone
Thiap-sat-lò-nì-kâ-heu-sû	Seconda lettera ai Tessalonicesi
Thiap-sat-lò-nì-kâ-chhièn-sû	Prima lettera ai Tessalonicesi
Pí-tet-chhièn-sû	Prima lettera di Pietro
Thì-mô-thai-chhièn-sû	Prima lettera a Timoteo
Lí Kông-yeu	Lee Kuan Yew
Chṳ̂-kâ-kô Thai-ho̍k	Università di Chicago
Tsṳ̂-fo-yen	Prefettura di Shiga
Mu-nì-het Kî-chhòng	Aeroporto di Monaco di Baviera
Yok-hon-ngi-sû	Seconda lettera di Giovanni
Thì-mô-thai-heu-sû	Seconda lettera a Timoteo
Thì-tô-sû	Lettera a Tito
Yî-sṳ̂-lâ-ki	Libro di Esdra
Nì-hî-mí-ki	Libro di Neemia
Pietersburg	Polokwane
Séu Pha̍k-Lù	Egretta garzetta
Chhòn-ngiam-phiang	Malattia infettiva
Kôn-yàm	Epatite
Chhûn-chiet	Capodanno cinese
Shinzō Abe	Shinzō Abe
Mpumalanga-sén	Mpumalanga
Pet Khôi-phú-sén	Provincia del Capo Settentrionale
Tó-kîn-yen	Prefettura di Shimane
Kông-sân-yen	Prefettura di Okayama
Gauteng-sén	Gauteng
Thung-fûng	Gotta
Chông-fa-yen	Contea di Changhua
Thai-fûn-yen	Prefettura di Ōita
Tiâu-tshí-yen	Prefettura di Tottori
Nùng-la̍k	Calendario cinese
Kô-tî-yen	Prefettura di Kōchi
Liû-liên	Durian
Pha̍k-hèu	Difterite
Exeter	Exeter
Saint Lawrence-hò	San Lorenzo (fiume)
Limpopo-sén	Provincia del Limpopo
Kô-tén Kau-yuk	Istruzione superiore in Italia
Sân-tá-kîn	Sandakan
Â-pí	Kota Kinabalu
Ngi̍t-pún thúng-tshṳ sṳ̀-thoi (Thòi-vân)	Taiwan sotto il dominio giapponese
Phok Kiún-fi	Park Geun-hye
Lévis	Lévis
Thòi-nàm-sṳ	Tainan
Laval (Québec)	Laval (Canada)
Mâ-lòi Pô-lî-nì-sî-â Ngî-chhu̍k	Lingue maleo-polinesiache
Fên-yòng-sṳ	Hengyang
Mân-chiu-tshu̍k	Manciù
Zambrów	Zambrów
Doetinchem	Doetinchem
Zamość	Zamość
Malbork	Malbork
Groesbeek	Groesbeek
Mì-chit-fûn-ho̍k	Calcolo infinitesimale
Ngo̍k-yòng-sṳ	Yueyang
BP	BP (azienda)
Sú-thiàu	Patate fritte
Yùn-lìm-yen	Yunlin
Vî-liâm Â-li̍t-sân-thai (Hò-làn)	Guglielmo Alessandro dei Paesi Bassi
Krasnystaw	Krasnystaw
Sî-kung-khî	Distretto di Sai Kung
Mâ-nâ-sî-vòng	Manasse (re di Giuda)
Kî-kîm-fi	Fondazione (ente)
A-hîn Kôn-yàm	Epatite A
Yù-tsiâm-vong-khî	Distretto di Yau Tsim Mong
Fûng-sái	Diospyros kaki
Tshṳ̍t-tshòng	Retto
Chhṳ-yù Pâng-sén	Free State
Tsó-fo-yen	Prefettura di Saga
Tet-tó-yen	Prefettura di Tokushima
Sî-pân-ngà-ngìn	Spagnoli
Fu̍t-chhṳ̂ Khiung-chṳn Sṳ̀n-siong	Imaging a risonanza magnetica
Hiông-tshon-yen	Prefettura di Kagawa
Reading, Berkshire	Reading
Kâ-chû Lî-kûng Ho̍k-yen	California Institute of Technology
Vì-ngì-tshṳ-páu Thai-ho̍k	Università di Würzburg
Êu-kí-lî-tet Kí-hò	Geometria euclidea
Si̍t-kuk	Silicon Valley
Barneveld	Barneveld
Khiu Tha̍t-sîn	Thaksin Shinawatra
Thòi-sân-sṳ	Taishan
Kîm-kôa	Zucca
Thai Sùn-thâ Khiùn-tó	Grandi Isole della Sonda
Elburg	Elburg
Doesburg	Doesburg
Sî-pet-sén	Provincia del Nordovest (Sudafrica)
Sien-thon	Segmento
Kâ-ngi-yen	Contea di Chiayi
Vûn-tai	Zona temperata
Â-kûng	Nonno
Thai-khi̍t-khièn	Taijiquan
Kiok-khwá	Caviglia
Hò-làn Tâi-thi Sat-khiet-sùn-ngî	Basso sassone
Pân-kiêu-é	Streptopelia turtur
Tshòng-khì-yen	Prefettura di Nagasaki
Hà-chhèu	Dinastia Xia
Chû-vì Sṳ̀n-kîn Ne-thúng	Sistema nervoso periferico
Lùn-tûn Thai-ho̍k	Università di Londra
Kip-sú	Serie
Nelspruit	Nelspruit
Sâ-là-ye̍t-chû	Sarawak
Â-chû Thai-phìn-yòng Kîn-tsi Ha̍p-tsok Fi-ngi	Asia-Pacific Economic Cooperation
Kôan-chiet-yàm	Artrite
Geldermalsen	Geldermalsen
Montauban	Montauban
Chhòng-sâ-sṳ	Changsha
Thai Put-lie̍t-tiên lâu Oi-ngì-làn Lièn-ha̍p Vòng-koet	Regno Unito di Gran Bretagna e Irlanda
Kiok-kiên	Tallone (anatomia)
Kûng-fûn	Centimetro
Lièn-ha̍p Hòng-khûng	United Airlines
Yen-thèu	Faringe
Hò-mí	Millimetro
Tsûng-tsang-khî (Thòi-pet-sṳ)	Distretto di Zhongzheng
Mì-mí	Micrometro (unità di misura)
Khi̍t-han (Sú-ho̍k)	Limite (matematica)
Theu-fú	Tōfu
Phù-sat	Bodhisattva
Chóng-ló Kau-fi	Presbiterianesimo
Hien-thoi Veloster	Hyundai Veloster
Nai-mí	Nanometro
Berlanga de Duero	Berlanga de Duero
Pâ-chûng-sṳ	Bazhong
Sâ-pâ-chû	Sabah
Nàm-nèn-sṳ	Nanning
Yù-sṳn-mî-thi Koet-kâ Kûng-yèn	Parco nazionale di Yosemite
Chhiâng-set	Ciano
Ho̍k-yen	Facoltà universitaria
Kô-hiùng-sṳ	Kaohsiung
Pet-mî Chhṳ-yù Mo-yi Hia̍p-ngi	North American Free Trade Agreement
Sû-kak-làn-ngìn	Scozzesi
Rustenburg	Rustenburg
Yen-tsong-fui	Concerto (evento musicale)
Yù-fu̍t-chû	Johor
Ngò-lò-sṳ̂ Lièn-pâng Chhṳ̍t-hot-sṳ	Città federali della Federazione russa
Fì-tshu̍k	Hui (popolo)
Sha̍k-sṳ	Laurea magistrale
Preston, Lancashire	Preston
Sî-tí-kâ-vòng	Sedecia
Sâm-koet	Tre Regni
Chhûn-chhiû Sṳ̀-khì	Periodo delle primavere e degli autunni
Chan-koet Sṳ̀-khì	Periodo dei regni combattenti
Mâ-liuk-kap-chû	Malacca
Pietermaritzburg	Pietermaritzburg
Sú-vón	Polso
Kit-làn-tan-chû	Kelantan
Tshông-tshu̍k	Tibetani
Pîn-sàng-chû	Penang
Blackburn	Blackburn
Chûng-sin Pha̍k-hiet-khiû	Granulocita neutrofilo
Pâng-kâ-tó	Bangka
Phìn-chhông-khiùn	Pyeongchang
Thai-koet Koet-chi Hòng-khûng Kûng-sṳ̂	Thai Airways International
Thai Ngi̍t-pún Ti-koet	Impero giapponese
Hiûng-nù	Xiongnu
Phit-li̍t-chû	Perak
Lùn-tûn Ti-koet Ho̍k-yen	Imperial College London
Tsen-sàng-sṳ	Zengcheng
Kui-lìm-sṳ	Guilin
Siet-làn-ngô-chû	Selangor
Tui-kok-sien	Diagonale
Fi-li-phi Liuk-sṳ	Filippo VI di Spagna
Kûng-tún	Tonnellata
Phàng-hên-chû	Pahang
中國象棋	Xiangqi
Pit-sṳn-hak	Pizza Hut
Yim-suk Siáu-tsṳ́	Sonic the Hedgehog
Ngo̍k-vûn-khiet-tshu̍k	Evenchi
Nàm-kîn Thai-thù-sat	Massacro di Nanchino
Yún Chṳ-Hau	Yun Chi-Ho
Phì-mí	Picometro
Chûng-koet 2010-ngièn Sông-hói Sṳ-kie Pok-lám-fi	Expo 2010
Carlisle, Cumbria	Carlisle
Sandomierz	Sandomierz
Ngit-tèu-kông	Radiazione solare
Khwon-kûan-tsiet	Anca
Fûn-kî-hon-khiûn	Mycobacterium
Chàu-yòng-sṳ	Shaoyang
Phìn-tûng-yen	Contea di Pingtung
Chông-fa-sṳ	Changhua
Hién-mì-kiang	Microscopio
Chông-kâ-kie-sṳ	Zhangjiajie
Chṳ Sṳ̀n-kûng	Koxinga
Chon-hiuk	Zhuanxu
Chu-chû-sṳ	Zhuzhou
Kûng-tshun	Decimetro
McGill Thai-ho̍k	Università McGill
Sâm-fòng Ńg-ti	Tre Augusti e Cinque Imperatori
Sanok	Sanok
Mâ-tshâ	Carro da guerra
Milton Keynes	Milton Keynes
Ên-tién	Grazia (teologia)
Hî-lìn-tên-khî	Hillingdon
Chṳ̂-yòng-sṳ	Ziyang
Chang Thien-chṳ́ Fat-sa Kie-son-kî Thôn-chhèn Só-mèu	Tomografia a emissione di positroni
Przemyśl	Przemyśl
Chhiòn-khiû Sàng-sṳ	Città globale
Pî-mí	Fermi (unità di misura)
Burnley	Burnley
Tûng Lùn-tûn, Tûng Khôi-phú-sén	East London
Biała Podlaska	Biała Podlaska
Pet-hói-sṳ	Beihai
Mafikeng	Mafikeng
Mí-sâ-yên Khiùn-tó	Visayas
Lò-pô-ôn-vòng	Roboamo
Slough	Slough
Thì-mô-thai	Timoteo vescovo
Chho̍k-sṳ̂-lia̍p	Centromero
Tûng-hò, Néu-yok-sṳ	East River
Chhêu-fông-hìn	Ipercubo
Sêm-mî-làn-chû	Negeri Sembilan
Brzeg	Brzeg
Fidel Valdez Ramos	Fidel Valdez Ramos
Łomża	Łomża
Siong-thâm-sṳ	Xiangtan
Thûng-tshu̍k	Dong (popolo)
Thòi-vân Ngièn-tshu-mìn	Aborigeni di Taiwan
騷靈現象	Poltergeist
Tha̍t-vat-ngì-tshu̍k	Daur
Na̍p-sî-tshu̍k	Naxi
Outaouais	Outaouais
Kuî-é	Testudines
Pak-sâ-sat	Baldassar
Tshièn-pí	Avambraccio
Yî-set-lie̍t Vòng-koet	Regno di Israele
Sîn-sân-sṳ	Johor Bahru
Khiu-kîm-sân Vân	Baia di San Francisco
Li Mâ-teu	Matteo Ricci
Tshài Yîn-vùn	Tsai Ing-wen
Chełm	Chełm
Â-ha̍p-vòng	Acab
Suwałki	Suwałki
Ngì-làn-yen	Contea di Yilan
Sî-làn-ngî	Lingua zelandese
Epe	Epe (Paesi Bassi)
Maidenhead	Maidenhead
Chû Khiet-lùn	Jay Chou
Winburg	Winburg
Kiú-liùng	Caolun
Nâ-pô-nì-tha̍t	Nabonide
Ngie-mí-li-ôn Lò-mâ-nok-ngî	Lingua emiliano-romagnola
Sîn-pet-sṳ	Nuova Taipei
Hî-sî-kâ-vòng	Ezechia
Thòi-chûng-sṳ	Taichung
IPhone 4S	IPhone 4S
Fâ-lièn-yen	Contea di Hualien
Kîm-mùn-yen	Kinmen
Thòi-tûng-yen	Contea di Taitung
Sîn-chuk-sṳ	Hsinchu
Kâ-ngi-sṳ	Chiayi
Kî-lùng-sṳ	Keelung
Pet-thèu-khî (Thòi-pet-sṳ)	Distretto di Beitou
Thai-ôn-khî (Thòi-pet-sṳ)	Distretto di Daan
Sṳ-lìm-khî (Thòi-pet-sṳ)	Distretto di Shilin
Busko-Zdrój	Busko-Zdroj
Àu-thai-li-â Ngièn	Dollaro australiano
Mò Chhiang-li ke Thung-vu̍t	Animali impuri
Kroonstad	Kroonstad
Hon-ho̍k	Sinologia
Thai-thùng-khî (Thòi-pet-sṳ)	Distretto di Datong
Nàm-kóng-khî (Thòi-pet-sṳ)	Distretto di Nangang
Nui-fù-khî (Thòi-pet-sṳ)	Distretto di Neihu
Tshiùng-sân-khî (Thòi-pet-sṳ)	Distretto di Songshan (Taipei)
Van-fà-khî (Thòi-pet-sṳ)	Distretto di Wanhua
Vùn-sân-khî (Thòi-pet-sṳ)	Distretto di Wenshan
Sin-ngi-khî (Thòi-pet-sṳ)	Distretto di Xinyi
Tsûng-sân-khî (Thòi-pet-sṳ)	Distretto di Zhongshan (Taipei)
Yî-pó-sṳ	Ipoh
Ná-pô-pha-lâ-sâ-ngì	Nabopolassar
Â-pí-ngâ-vòng	Abia di Giuda
Sûn N̂g	Regno Wu
Pha̍k-chhu̍k	Bai (popolo)
Pińczów	Pińczów (città)
Aalten	Aalten
Xuxa	Xuxa
Hajnówka	Hajnówka
Lubartów	Lubartów
Lucélia Santos	Lucélia Santos
IPhone 3GS	IPhone 3GS
IPhone 4	IPhone 4
IPhone 3G	IPhone 3G
Alan Dawa Dolma	Alan Dawa Dolma
Tûng-Chû	Dinastia Zhou orientale
Mâ-lòi-sî-â Hòng-khûng	Malaysia Airlines
Lì-tshu̍k	Li (popolo)
Chûng-sî-khî (Hiông-kóng)	Distretto Centrale e Occidentale
Â-ha̍p-chhia-vòng (Yî-set-lie̍t)	Acazia
Â-sat-li-ngâ	Ozia
Peter Nalitch	Peter Nalitch
Yâ-lò-pô-ôn yit-sṳ	Geroboamo
Am-li-vòng	Omri
Nâ-tap-vòng	Nadab
Pâ-sâ-vòng	Baasha
Yâ-fu-vòng	Jehu
Yok-sî-â-vòng	Giosia
Yok-â-sṳ̂-vòng (Yù-thai)	Ioas
Sîm-li-vòng	Zimri
Yâ-lò-pô-ôn ngi-sṳ	Geroboamo II
Yî-vi-mí-lò-tha̍t	Amil-Marduk
Â-mâ-chhia-vòng	Amasia (Giuda)
Yî-sṳ̂-pô-sat-vòng	Is-Bàal
Â-sat-vòng	Asa di Giuda
Â-mùn-vòng	Amon (re di Giuda)
Chong Koet-yùng（Chong Fat-chûng）	Leslie Cheung
Lí Tên-Fî	Lee Teng-hui
Yî-lâ-vòng	Ela (re)
Yok-ngâ-kin-vòng	Ioiakim
Yok-ngâ-kîn-vòng	Ioiachin
Biłgoraj	Biłgoraj
Puławy	Puławy
Chuk Hon	Regno Shu
Chhâu Ngùi	Regno Wei
Abitibi-Témiscamingue	Abitibi-Témiscamingue
Mò-tóng-sit	Indipendente (politica)
Iwakuni-sṳ	Iwakuni
Soi-ha-tshu̍k	Saisiyat
Kâu-thûng kûng-khí	Mezzo di trasporto
Yok-â-sṳ̂-vòng (Yî-set-lie̍t)	Ioas di Israele
Yok-làn-vòng (Yî-set-lie̍t)	Joram (re d'Israele)
Khiu Sṳ̀n-thûng	Shing-Tung Yau
Fùng Puk-kím Kiê	Chrysolophus pictus
Grajewo	Grajewo
Sat-lâ-tshu̍k	Salar (popolo)
Yok-ha̍p-sṳ-vòng	Ioacaz
Sîn-tiam-khî	Xindian (città)
瑤族	Yao (popolo)
Thú-sàng-khî	Tucheng
Hagi-sṳ	Hagi
Chûng-chhiû-chiet	Festa di metà autunno
Nài-lî-kak-li-sâ-ngì	Neriglissar
Fùng-theu	Vigna angularis
Łuków	Łuków
Świdnik	Świdnik
Pô-sṳ̂ Ti-koet	Impero achemenide
Nagato-sṳ	Nagato
Mâ-thai-fuk-yîm	Vangelo secondo Matteo
Sṳ̍p-sṳ-ka	Croce cristiana
Â-chû Hòng-khûng X	AirAsia X
Â-chû Hòng-khûng	AirAsia
Yî-fut-só-sû	Lettera agli Efesini
Sòng-tet-sṳ	Changde
Yit-yòng-sṳ	Yiyang
Chhim-chû-sṳ	Chenzhou
Tshî Kông-khí	Xu Guangqi
Yî-lò-khén-nok-ngî	Ilocano
Súi-nèn-sṳ	Suining
Nui-kông-sṳ	Neijiang
Tha̍t-chû-sṳ	Dazhou
Ngá-ôn-sṳ	Ya'an
10000	10000
Fú-kûa	Momordica charantia
Fún-fùng-set	Rosa (colore)
Nâ-sat-le̍t	Nazaret
Yî-tshu̍k	Yi (popolo)
Â-thâ-li-ngâ	Atalia di Giuda
Augustów	Augustów
Windsor, Berkshire	Windsor (Regno Unito)
Kô Khô-kî	Alta tecnologia
Hòn Hòn	Han Han
Tczew	Tczew
Hâ-nì-tshu̍k	Hani
Thòi-nàm-yen	Contea di Tainan
Fù-chṳ-mìn-sṳ Kî-chhòng	Aeroporto Internazionale Tan Son Nhat
Hien-thoi Accent	Hyundai Accent
Hien-thoi Sonata	Hyundai Sonica
Hien-thoi Elantra	Hyundai Elantra
Hien-thoi Equus	Hyundai Equus
Vû-tsṳ-phe̍t-khiet-chhu̍k	Uzbeki
Hien-thoi Genesis Coupé	Hyundai Genesis Coupé
Thap-kit-khiet-tshu̍k	Tagiki
Wal-Mart Kûng-sṳ̂	Walmart
緋彈个婭里婭	Hidan no Aria
Yùn-tôn yun-son	Cloud computing
Ńg-sùn-chiet Yun-thung	Pentecostalismo
Liu̍k-theu	Vigna radiata
Chêu-siên-chhu̍k	Coreani
Khúa-ngì-khiet-tsṳ-tshu̍k	Kirghisi
Burgo de Osma-Ciudad de Osma	Burgo de Osma-Ciudad de Osma
Sông-hói Ha̍p-tsok Tsû-tsṳt	Organizzazione di Shanghai per la cooperazione
Reus	Reus
San Esteban de Gormaz	San Esteban de Gormaz
Hien-thoi Santa Fe	Hyundai Santa Fe
Het-mien Phî-lù	Platalea minor
Sâ-â-nàm	Shah Alam
Kit-lùng-po Koet-chi Kî-chhòng	Aeroporto Internazionale di Kuala Lumpur
Ngiu̍k-Sân	Yu Shan
Hōfu-sṳ	Hōfu
Starogard Gdański	Starogard Gdański
Het-tsat-tshu̍k	Hezhen
Sîn-chhèu	Dinastia Xin
Mauricie	Mauricie
Kâu-thûng	Trasporto su strada
Khiùn	Comanderia
Vû-yìn	Muscidae
Tha̍t-mâ-thai	Dalmazia
Edenville	Edenville
Mâ-lî-sûn	Robert Morrison
Thai-lî-khî	Dali (Taichung)
Fûng-ngièn-sṳ	Fengyuan
Vú-fûng-hiông	Wufeng
Kîm-sân-khî	Jinshan
Phìn-hâi-khî	Pingsi
Sâm-hia̍p-khî	Sanxia
Thâm-súi	Tamsui
Sip-chṳ-khî	Xizhi
Yún-fò-khî	Yonghe
Fû-lùn-pi-ngì-sṳ	Hulunbuir
Ǹg-chiu-sṳ	Wuzhou
Fòng-sàng-kóng-sṳ	Fangchenggang
Khîm-chiu-sṳ	Qinzhou
Kui-kóng-sṳ	Guigang
Ngiu̍k-lìm-sṳ	Yulin
Pak-set-sṳ	Baise
Fo-chiu-sṳ	Hezhou
Hò-chhṳ̀-sṳ	Hechi
Lòi-pîn-sṳ	Laibin
Chhùng-chó-sṳ	Chongzuo
Thú-kâ-tshu̍k	Tujia
Sîn-kie	Nuovi Territori
Mo-yi	Commercio
Kędzierzyn-Koźle	Kędzierzyn-Koźle
Duiven	Duiven
Yo̍k-ho̍k	Farmacia
Kóng-tó-yen	Prefettura di Hiroshima
Thu̍k-liùng-tshu̍k	Derung
Tseu-tshu̍k	Tsou
IPhone (Thi-yit thoi)	IPhone EDGE
Ye̍t-nàm-ngî sṳ-mû	Alfabeto vietnamita
Ólvega	Ólvega
Fung-sân-sṳ	Fengshan
Thú-ngí-khì-ngî sṳ-mû	Alfabeto turco
Shūnan-sṳ	Shūnan
Skarżysko-Kamienna	Skarżysko-Kamienna
Longás	Longás
Kô-tá-ha̍p-lû-sṳ	Kota Bharu
Sú-chiuk-khiéu-phiang	Malattia mano-piede-bocca
Kông-phú	Spettro atomico
Chhṳ̂m-súi-phu-khî	Distretto di Sham Shui Po
Mielec	Mielec
客家	Hakka (popolo)
Wejherowo	Wejherowo
Pu-yî-chhu̍k	Bố Y
Ngì-làn-sṳ	Yilan
Ńg-fù Sṳ̍p-liuk-koet	Sedici regni
Néu-yok Tû-fi-khî	Area metropolitana di New York
歷峯雧團	Gruppo Richemont
Lanaudière	Lanaudière
Thap-lùn-ti-nò-ngî	Dialetto tarantino
Vòng Sîm-lìn	Cyndi Wang
Chhṳ̀n Kâ-fà	Ella Chen
Mâ-kûng-sṳ	Magong
Sîn-yàng-sṳ	Xinying
Sû-o-tsṳ́n	Su-ao
Làn-yí	Orchid Island
Mèu-li̍t-sṳ	Miaoli
2009-ngièn sṳ-kie yun-thung-fi	Giochi mondiali 2009
Nàm-o-hiông	Nan-ao
Thai-ngâ-tshu̍k	Atayal
Liu̍k-tó-hiông	Green Island (Taiwan)
Pu-nùng-tshu̍k	Bunun
Lò-tûng-tsṳ́n	Luodong
Thèu-sàng-tsṳ́n	Toucheng
Sîn-sṳ-hiông	Xinshi
Pî-nàm-tshu̍k	Puyuma
Kit-ôn-hiông	Ji'an
Yún-không-sṳ	Yongkang
Tha̍t-ngu-tshu̍k	Tao (popolo)
Phû-lî-tsṳ́n	Puli (Taiwan)
Thai-thùng-hiông	Datong (Taiwan)
Pô-chûng-hiông	Baozhong
Tsiâu-hâi-hiông	Jiaoxi
Thai-lû-kok Koet-kâ Kûng-yèn	Parco Nazionale Taroko
Sṳ̀n-kûng-tsṳ́n	Chenggong
Hâi-chû-hiông	Xizhou
Kûan-sân-tsṳ́n	Guanshan
Yòng-mìn-sân Koet-kâ Kûng-yèn	Yangmingshan
Hak-kâ chhoi	Cucina Hakka
Phìn-fông Kûng-lî	Chilometro quadrato
Fâ-lièn-sṳ	Hualien
Phìn-tsṳ́n-sṳ	Pingzhen
Shuì-ôn-sṳ	Rui'an
Phìn-tûng-sṳ	Pingtung
Thòi-tûng-sṳ	Taitung
F4	JVKV
Chùng-chṳ́	Zongzi
Then Yí-hièn	Teng Yu-hsien
Thòi-pet Tshia̍p-yun	Metropolitana di Taipei
Chhòn-yùng Hòng-khûng	EVA Air
Nàm-thèu-sṳ	Nantou
Phài-vân-tshu̍k	Paiwan
Thòi-vân nàm-tó ngî-ngièn	Lingue formosane
Lìm-pâ Se-pâu	Linfocita
Phài-vân-ngî	Lingua paiwan
Thai-ngâ-ngî	Lingua atayal
Thò-yèn-sṳ	Taoyuan
Lû-khái-tshu̍k	Rukai
Pî-nàm-ngî	Lingua puyuma
Soi-ha-ngî	Lingua saisiyat
Hak-kâ thú-lèu	Tulou
Kô-sîn-shì	Imperatore Ku
Jarosław	Jarosław
Tûng-khî (Hiông-kóng)	Distretto Est (Hong Kong)
Gaspésie–Îles-de-la-Madeleine	Gaspésie-Îles-de-la-Madeleine
Ostrowiec Świętokrzyski	Ostrowiec Świętokrzyski
Tshiâ-tshu̍k	She (popolo)
Sên-sán	Produzione
Chojnice	Chojnice
Bronckhorst	Bronckhorst
Thi-kip-sṳ	Città-prefettura
Mine-sṳ	Mine (Giappone)
Mì-fûn-ho̍k	Differenziale (matematica)
Tûng-hiông-tshu̍k	Dongxiang
Lâ-fú-tshu̍k	Lahu
Włodawa	Włodawa
Starachowice	Starachowice
Stalowa Wola	Stalowa Wola
Chat-ho̍k Pok-sṳ	Dottorato di ricerca
Lì-tó-khî	Distretto delle Isole
Ermelo	Ermelo
Thông-phûng	Apidae
Tshûng-shîn-yen	Prefettura di Okinawa
Tshòng-lo̍k-sṳ	Changle
Nàm-thin-sṳ	Nam Dinh
Montpellier Thai-ho̍k	Università di Montpellier
Luceni	Luceni
Fà-khièu	Cinesi d'oltremare
Madrid Chhṳ-chhṳ Thai-ho̍k	Università autonoma di Madrid
Medway	Medway (borough)
Nysa, Pô-làn	Nysa
Belver de Cinca	Belver de Cinca
Pó-ôn-chhu̍k	Bonan
Culemborg	Culemborg
Kôan-tan-sṳ	Kuantan
Sokółka	Sokółka
Thâu-thông-shì	Yao (imperatore)
Hikari-sṳ	Hikari (Yamaguchi)
Krosno	Krosno
Kûng-lî	Chilometro
Almarza	Almarza
Aldealices	Aldealices
Aldealafuente	Aldealafuente
Alentisque	Alentisque
Adradas	Adradas
Alconaba	Alconaba
Abejar	Abejar
Aldealpozo	Aldealpozo
Alcubilla de las Peñas	Alcubilla de las Peñas
Aldealseñor	Aldealseñor
Alcubilla de Avellaneda	Alcubilla de Avellaneda
Covaleda	Covaleda
Almazul	Almazul
Arcos de Jalón	Arcos de Jalón
Aldehuela de Periáñez	Aldehuela de Periáñez
Almenar de Soria	Almenar de Soria
Vinuesa	Vinuesa
Duruelo de la Sierra	Duruelo de la Sierra
San Leonardo de Yagüe	San Leonardo de Yagüe
Shâu-sân-sṳ	Shaoshan
Tai-tshu̍k	Dai (popoli)
Mùn-pâ-tshu̍k	Monpa
Kudamatsu-sṳ	Kudamatsu
Kiong-tshu̍k	Qiang
Afrikaner-ngìn	Afrikaner
Yîn-koet-ngìn	Britannici
Ngá-tshu̍k	Va (popolo)
Brummen	Brummen
Kûng-yîn	Ettometro
Fû-yûng-sṳ	Seremban
Jasło	Jasło
Â-chhông-chhu̍k	Achang
Bielsk Podlaski	Bielsk Podlaski
Beuningen	Beuningen
Thú-tshu̍k	Tu (popolo)
Kîn-mí	Gigametro
Súi-tshu̍k	Shui
Nyet-láu-tshu̍k	Gelao
Kín-phó-tshu̍k	Jingpo
Lo̍k-pâ-tshu̍k	Lhoba
Li̍t-siuk-tshu̍k	Lisu
Vì-kî Pak-khô Ngî-ngièn Lie̍t-péu	Wikipedia:Tutte le lingue
Siên-pî-chhu̍k	Xianbei
Sanyo-Onoda-sṳ	Sanyō-Onoda
Billingham	Billingham
Pet-khî (Hiông-kóng)	Distretto Nord (Hong Kong)
Mô-nàm-tshu̍k	Maonan
Nu-tshu̍k	Nu (popolo)
Mu̍k-láu-tshu̍k	Mulao
Sî-sûng-pán-na̍p Thài-tshu̍k Tshṳ-tshṳ-chû	Prefettura autonoma dai di Xishuangbanna
Ngièn-lóng-khî	Distretto di Yuen Long
Kôn-thòng-khî	Distretto di Kwun Tong
Khwûi-tshiâng-khî	Distretto di Kwai Tsing
Phù-mí-tshu̍k	Pumi
Thai-pu-khî	Distretto di Tai Po
Tet-ngo-tshu̍k	De'ang
Vòng-thai-siên-khî	Distretto di Wong Tai Sin
Tshiên-vân-khî	Distretto di Tsuen Wan
Pu-lóng-chhu̍k	Blang
Bracknell Sêm-lìm	Bracknell Forest
Tomaszów Lubelski	Tomaszów Lubelski
Hàng-thung Chok-ngia̍p Ne-thúng	Sistema operativo per dispositivi mobili
Hrubieszów	Hrubieszów
Pet Québec Thi-khî	Nord-du-Québec
Montérégie	Montérégie
Druten	Druten
Nàm-hiùng-sṳ	Nanxiong
Dębica	Dębica
Québec-ngìn Tóng	Parti Québécois
Cape Town Thai-ho̍k	Università di Città del Capo
Sasolburg	Sasolburg
Kraśnik	Kraśnik
Dęblin	Dęblin
Radzyń Podlaski	Radzyń Podlaski
Thûn-mùn-khî	Distretto di Tuen Mun
Kiú-liùng-sàng-khî	Distretto di Kowloon City
Nàm-khî (Hiông-kóng)	Southern District (Hong Kong)
Vân-chái-khî	Distretto di Wan Chai
Villanueva de Sigena	Villanueva de Sigena
Tân-vi	Unità
Stockton-on-Tees	Stockton-on-Tees
Wokingham	Wokingham
Kô-lò-sî	Colossi
Khiâm-nàm Pu-yî-tshu̍k Mèu-tshu̍k Tshṳ-tshṳ-chû	Prefettura autonoma buyei e miao di Qiannan
Lìm-ha Fì-tshu̍k Tshṳ-tshṳ-chû	Prefettura autonoma Hui di Linxia
Middelburg, Tûng Khôi-phú-sén	Middelburg (Provincia del Capo Orientale)
Orania	Orania
Â-pa Chhong-chhu̍k Kiông-chhu̍k Chhṳ-chhṳ-chû	Prefettura autonoma tibetana e Qiang di Aba
Welkom	Welkom
Swellendam	Swellendam
Fû-yûng-khî	Distretto di Furong
Vi	Stomaco
Liùng-hâ	Nephropidae
Kî-nok-tshu̍k	Jino
Ngo̍k-lùn-tshùn-tshu̍k	Oroqen
Chaudière-Appalaches	Chaudière-Appalaches
Sî-Chû	Dinastia Zhou occidentale
Sṳ̀n-Hòn	Cheng Han
Pet-ngan Thi-khî (Québec)	Côte-Nord
Néu-yok-kóng	Porto di New York
Tha̍k-é	Dizi
Tûng-Hon	Dinastia Han orientale
Tân-yit kón-lî-khî	Autorità unitaria
Àu-choi Fôn	Ephippiorhynchus senegalensis
Kî-chhòng	Aeroporto
Sé-kiok-lî	Lavanda dei piedi
Ngìn-kûng Hi-kôn	Organo artificiale
Sân-sî Sṳ-sa	Son Tay
Windsor lâu Maidenhead	Royal Borough of Windsor and Maidenhead
Thí-ngoi Mo̍k-yòng-ha̍p	ECMO
Lìm Tan	Lin Dan
分類:Tet-koet	Categoria:Germania
分類:Yi-thai-li	Categoria:Italia
分類:Kâ-nâ-thai	Categoria:Canada
分類:Sî-pân-ngà	Categoria:Spagna
分類:Chûng-koet	Categoria:Cina
分類:Ngi̍t-pún	Categoria:Giappone
分類:Àu-thai-li-â	Categoria:Australia
分類:Yin-thu	Categoria:India
分類:Yî-set-lie̍t	Categoria:Israele
分類:Nàm-fî	Categoria:Sudafrica
Redcar and Cleveland	Redcar and Cleveland
分類:Yin-thu-nì-sî-â	Categoria:Indonesia
分類:Pâ-kî-sṳ̂-thán	Categoria:Pakistan
分類:Pô-làn	Categoria:Polonia
分類:Sîn-kâ-po	Categoria:Singapore
分類:Hòn-koet	Categoria:Corea del Sud
分類:Thai-koet	Categoria:Thailandia
分類:Ye̍t-nàm	Categoria:Vietnam
分類:Phú-nen-lui	Categoria:Mammiferi
分類:Tiâu	Categoria:Uccelli
分類:Chhṳ̍t-vu̍t	Categoria:Piante
分類:Vu̍t-lí-ho̍k	Categoria:Fisica
分類:Chhṳ-yèn Khô-ho̍k	Categoria:Scienze naturali
分類:Sâng-vu̍t-ho̍k	Categoria:Biologia
分類:Fa-ho̍k	Categoria:Chimica
分類:Li̍t-sṳ́	Categoria:Storia
分類:Thi-lî	Categoria:Geografia
分類:Sa-fi	Categoria:Società
分類:Chûng-kau	Categoria:Religione
分類:Thí-yuk	Categoria:Sport
分類:Khô-ho̍k	Categoria:Scienza
分類:Lièn-ha̍p-koet	Categoria:Nazioni Unite
分類:Êu-chû Lièn-mèn	Categoria:Unione europea
分類:Kien-chuk-vu̍t	Categoria:Edifici
分類:Thûng-sin	Categoria:Comunicazione
分類:Thi-khiù	Categoria:Terra
Sî Berkshire	West Berkshire
Hiông-kóng Thiet-lu Yû-han Kûng-sṳ̂	MTR Corporation
Zuera	Zuera
Brotton	Brotton
Langa del Castillo	Langa del Castillo
Contamina	Contamina
Louis Trichardt	Louis Trichardt
Abiego	Abiego
Abanto	Abanto
Kú Lò-mâ	Civiltà romana
La Fueva	La Fueva
Tsui-heu ke Sṳ́m-phan	Giudizio universale
Greenwich Thai-ho̍k	Università di Greenwich
Eston	Eston
Middelburg, Mpumalanga-sén	Middelburg (Mpumalanga)
分類:Chet-ho̍k	Categoria:Filosofia
分類:Fu̍t-kau	Categoria:Buddhismo
分類:Kî-tuk-kau	Categoria:Cristianesimo
分類:Yù-thai-kau	Categoria:Ebraismo
Sià-ok Sṳn-kîn	Bibbia Cattiva
Hò-sṳ̂n	Millilitro
Bochotnica	Bochotnica
Trompsburg	Trompsburg
Ngi̍t-pún Khûn-chhùng Ki	Cronache entomologiche del Giappone
分類:Hàng-sên	Categoria:Pianeti
分類:Vùn-fa	Categoria:Cultura
分類:Ngìn-vùn Khô-ho̍k	Categoria:Scienze umanistiche
分類:Tî-sṳt	Categoria:Conoscenza
Chṳ́-set	Porpora
Ap-è	Anatra
Lù-tshṳ̀	Phalacrocoracidae
分類:Yên-yèn	Categoria:Attori
模板:Tl	Template:Tl
模板:Userbox	Template:Userbox
分類:Koet-kâ	Categoria:Nazioni
Wikipedia:Kón-lî-yèn	Wikipedia:Amministratori
分類:Chûng-fà Mìn-chhu̍k	Categoria:Gruppi etnici in Cina
分類:Ngìn-vu̍t	Categoria:Persone
分類:Mìn-chhu̍k	Categoria:Gruppi etnici
Wikipedia:Hàng-tsṳn-yèn	Wikipedia:Burocrati
Wikipedia:IP chhà-fûng li-ngoi-chá	Wikipedia:Esenti dal blocco IP
Wikipedia:Kî-hi-ngìn	Wikipedia:Bot
分類:Sṳ̀-kiên	Categoria:Tempo
分類:Chhṳ-yèn	Categoria:Natura
分類:Kûng-chhàng	Categoria:Ingegneria
分類:Yî-ho̍k	Categoria:Medicina
分類:Chṳn-chṳ	Categoria:Politica
分類:Kau-yuk	Categoria:Educazione
分類:Kông-ho̍k	Categoria:Ottica
Âi-khi̍p	Egitto
分類:Chat-ho̍k-kâ	Categoria:Filosofi
模板:Bot	Template:Bot
Kâ-nâ-thai	Canada
分類:Hiûng-ngà-li	Categoria:Ungheria
分類:Hî-lia̍p	Categoria:Grecia
分類:Lâ-thot-vì-â	Categoria:Lettonia
分類:Yù-hi	Categoria:Giochi
Thiên-koet	Cielo (religione)
分類:Êu-chû koet-kâ	Categoria:Stati dell'Europa
分類:Êu-chû	Categoria:Europa
模板:Documentation	Template:Man
Wikipedia:Yung-fu	Wikipedia:Livelli di accesso degli utenti
Pok-sṳ	Dottore
Wikipedia:Sa-khî	Portale:Comunità
分類:Wikipedians by language	Categoria:Utenti per lingua
Sṳ̀n Chhai-kî	Sung Jae-gi
Khî-ngia̍p	Business
Ngiuk-yèn	Polpetta
模板:Softredirect	Template:Soft redirect
模板:Delete	Template:Cancella subito
分類:Kî-su̍t	Categoria:Tecnologia
分類:Ngî-ngièn	Categoria:Lingue
Wikipedia:Chhóng-kien Sîn Thiàu-muk	Aiuto:Come scrivere una voce
分類:還無索引嘅頁面	Categoria:Pagine non indicizzate
分類:含有損壞文件鏈接嘅頁面	Categoria:Pagine con link a file inesistenti
模板:Navbox	Template:Navbox
Pak-ha̍p-fâ	Lilium
模板:Tnavbar	Template:Tnavbar
模板:Unicode	Template:Unicode
模板:Smallcaps	Template:Maiuscoletto
模板:Nowrap	Template:Tutto attaccato
分類:Fî-chû	Categoria:Africa
分類:Gauteng-sén	Categoria:Gauteng
分類:Pet Khôi-phú-sén	Categoria:Provincia del Capo Settentrionale
分類:Sṳn-kîn	Categoria:Bibbia
分類:Limpopo-sén	Categoria:Provincia del Limpopo
分類:Sî Khôi-phú-sén	Categoria:Provincia del Capo Occidentale
分類:Si	Categoria:Libro
模板:Pâ-phe̍t	Template:Babel
模板:Reflist	Template:References
模板:Stub	Template:S
模板:User ca-1	Template:Utente ca-1
模板:User de	Template:Utente de
模板:User de-1	Template:Utente de-1
模板:User en-3	Template:Utente en-3
模板:User en-1	Template:Utente en-1
模板:User en-2	Template:Utente en-2
模板:User en-4	Template:Utente en-4
模板:User en-0	Template:Utente en-0
模板:User en	Template:Utente en
模板:User de-2	Template:Utente de-2
模板:User fr-2	Template:Utente fr-2
模板:User ja-1	Template:Utente ja-1
模板:User fr	Template:Utente fr
模板:Location map/Info	Template:Mappa di localizzazione/info
分類:Khûn-chhùng	Categoria:Insetti
分類:Â-chû	Categoria:Asia
分類:Chṳ-li	Categoria:Cile
分類:Sok-lî-â-sén	Categoria:Provincia di Soria
分類:Nàm-mî-chû	Categoria:America meridionale
分類:Khà-sṳ̂-tì-li-â lâu Lòi-ngong	Categoria:Castiglia e León
模板:Esoteric	Template:Template complesso
分類:Mâ-lòi-sî-â	Categoria:Malesia
分類:Sṳ̍t-phín	Categoria:Alimenti
模板:Mod	Template:Mod
模板:User es-2	Template:Utente es-2
模板:Fôn-ngiàng	Template:Benvenuto
分類:Thiàu-mi-liau	Categoria:Condimenti
分類:Chû-chṳt	Categoria:Organizzazioni
分類:Ngî-ngièn-ho̍k	Categoria:Linguistica
模板:ITA	Template:ITA
模板:非洲行政區劃	Template:Africa
模板:SVK	Template:SVK
模板:Infobox Country	Template:Stato
模板:TUR	Template:TUR
分類:User en-4	Categoria:Utenti en-4
分類:User en	Categoria:Utenti en
分類:User zh	Categoria:Utenti zh
分類:User zh-N	Categoria:Utenti zh-M
分類:User en-2	Categoria:Utenti en-2
模板:User zh	Template:Utente zh
模板:Cite web	Template:Cita web
分類:Hòng-khûng	Categoria:Aviazione
分類:Yím-sṳ̍t	Categoria:Alimentazione
模板:Fong-wui	Template:Punti cardinali
模板:BS3	Template:BS3
模板:IPA	Template:IPA
分類:Chṳn-chṳ Ngìn-lui	Categoria:Politici
分類:Mî-chû	Categoria:America
模板:其他	Template:Nota disambigua
分類:Language user templates	Categoria:Template Babel
Wikipedia:GNU自由文檔協議證書	Wikipedia:Testo della GNU Free Documentation License
模板:大洋洲行政區劃	Template:Oceania
分類:Vùn-ho̍k-kâ	Categoria:Scrittori
分類:Kiûn-sṳ	Categoria:Forze armate
分類:Thai-ho̍k	Categoria:Università
模板:Lang-he	Template:Ebraico
分類:Sṳ-kie Pok-lám-fi	Categoria:Esposizioni universali
分類:Chûng-fà Ngìn-mìn Khiung-fò-koet Chú-sit	Categoria:Presidenti della Repubblica Popolare Cinese
分類:Fu̍k-tsông	Categoria:Monaci buddhisti
模板:FIN	Template:FIN
模板:Purge	Template:Purga
模板:DNK	Template:DNK
模板:Provinces of China	Template:Province della Cina
模板:Userpage	Template:Pagina utente
模板:DEU	Template:DEU
模板:SWE	Template:SWE
分類:Ye̍t-nàm kî-chhòng	Categoria:Aeroporti del Vietnam
Kiet-tshòng	Colon
分類:Kûng-sṳ̂	Categoria:Aziende
模板:User fr-3	Template:Utente fr-3
模板:JPN	Template:JPN
分類:Thien-nó	Categoria:Computer
模板:MKD	Template:MKD
模板:LTU	Template:LTU
Mô-li-ngìn	Māori
分類:Tho-lu	Categoria:Strade
模板:Disambig	Template:Disambigua
分類:Khien-không Khô-ho̍k	Categoria:Scienze della salute
分類:Hàng-thung Thien-fa	Categoria:Telefoni cellulari
模板:User nan	Template:Utente zh-min-nan
模板:User nan-1	Template:Utente zh-min-nan-1
模板:GRC	Template:GRC
模板:Lang-grc	Template:Lang-grc
模板:CZE	Template:CZE
分類:Chhòn-ngiam-phiang	Categoria:Malattie infettive
分類:Sîn-kau	Categoria:Protestantesimo
模板:GBR	Template:GBR
分類:Sâng-vu̍t	Categoria:Forme di vita
模板:SVN	Template:SVN
模板:FRA	Template:FRA
模板:Hiông-kóng Hàng-tsṳn Khî-va̍k	Template:Distretti di Hong Kong
模板:User pt-2	Template:Utente pt-2
分類:Kâ-li-sî-â	Categoria:Galizia
模板:歐洲行政區劃	Template:Europa
分類:User yue	Categoria:Utenti yue
分類:User fr	Categoria:Utenti fr
分類:User ja	Categoria:Utenti ja
分類:User pt	Categoria:Utenti pt
分類:User nl-3	Categoria:Utenti nl-3
分類:User fr-2	Categoria:Utenti fr-2
分類:User ja-2	Categoria:Utenti ja-2
分類:User ko-N	Categoria:Utenti ko-M
分類:User fr-N	Categoria:Utenti fr-M
分類:Vùn-sṳ	Categoria:Sistemi di scrittura
分類:Tho-kau	Categoria:Taoismo
分類:User ca	Categoria:Utenti ca
分類:User ca-1	Categoria:Utenti ca-1
分類:User de	Categoria:Utenti de
分類:User de-2	Categoria:Utenti de-2
分類:User de-N	Categoria:Utenti de-M
分類:User en-3	Categoria:Utenti en-3
分類:User en-N	Categoria:Utenti en-M
分類:User es	Categoria:Utenti es
分類:User es-2	Categoria:Utenti es-2
分類:User es-N	Categoria:Utenti es-M
分類:Yî-set-lie̍t kiûn-vòng	Categoria:Re di Israele
分類:Yù-thai kiûn-vòng	Categoria:Re di Giuda
分類:Kí-hò-ho̍k	Categoria:Geometria
模板:Ye̍t-nàm	Template:Suddivisioni del Vietnam
分類:User ja-1	Categoria:Utenti ja-1
分類:User ko	Categoria:Utenti ko
分類:Lièn-ha̍p-koet Pi-sû-chóng	Categoria:Segretari generali delle Nazioni Unite
分類:Hói-yòng	Categoria:Mari
分類:Ido-ngî	Categoria:Ido
模板:LUX	Template:LUX
分類:Thai-yòng-ne	Categoria:Sistema solare
分類:Kóng-tûng-sén	Categoria:Guangdong
分類:Fuk-kian	Categoria:Fujian
分類:Koet-chi Chû-chṳt	Categoria:Organizzazioni internazionali
分類:Fat-mìn-kâ	Categoria:Inventori
分類:Yím-liau	Categoria:Bevande
分類:User nan-1	Categoria:Utenti zh-min-nan-1
分類:User nan-2	Categoria:Utenti zh-min-nan-2
分類:User nan-3	Categoria:Utenti zh-min-nan-3
分類:User nan-N	Categoria:Utenti zh-min-nan-M
分類:Sa-fi Khô-ho̍k	Categoria:Scienze sociali
分類:Mî-koet Koet-kâ Kûng-yèn	Categoria:Parchi nazionali degli Stati Uniti d'America
分類:Kô-tén Kau-yuk	Categoria:Istruzione superiore
分類:Thi-hìn	Categoria:Forme del suolo
分類:Pâ-lùn-sî-â Chhṳ-chhṳ-khî	Categoria:Comunità Valenzana
模板:User ja-2	Template:Utente ja-2
分類:Thiên-chú-kau	Categoria:Cattolicesimo
分類:User yue-N	Categoria:Utenti yue-M
分類:Yîm-ngo̍k-kâ	Categoria:Musicisti
模板:Lang	Template:Lang
分類:Fa-kâ	Categoria:Pittori
分類:Yin-thu chûng-kau	Categoria:Religione in India
分類:Ho̍k-su̍t	Categoria:Accademie e istituti di cultura
模板:CYP	Template:CYP
分類:Yin-thu Thi-lî	Categoria:Geografia dell'India
分類:Sông-ngia̍p	Categoria:Commercio
分類:Fap-koet fòng-ti	Categoria:Imperatori dei francesi
模板:EST	Template:EST
模板:AUT	Template:AUT
分類:Meu-khô	Categoria:Felidi
分類:Thòi-vân Thi-lî	Categoria:Geografia di Taiwan
模板:User zh-3	Template:Utente zh-3
分類:Nì-pok Thi-lî	Categoria:Geografia del Nepal
分類:Thai-khûng-ngìn	Categoria:Astronauti e cosmonauti
分類:Khî-ngia̍p-kâ	Categoria:Imprenditori
分類:Fî-li̍t-pîn	Categoria:Filippine
分類:User nl	Categoria:Utenti nl
分類:User zh-1	Categoria:Utenti zh-1
分類:User zh-3	Categoria:Utenti zh-3
分類:User zh-2	Categoria:Utenti zh-2
分類:Yin-thu kiûn-chú	Categoria:Sovrani di antichi Stati indiani
分類:Ho̍k-vi	Categoria:Titoli accademici
分類:Pô-sṳ̂ koet-vòng	Categoria:Sovrani di Persia
分類:Kîm-yùng	Categoria:Finanza
分類:Thien-sṳ	Categoria:Televisione
分類:Chhòn-kau-sṳ	Categoria:Missionari
分類:Hói-hia̍p	Categoria:Stretti
分類:Yin-Êu Ngî-ne	Categoria:Lingue indoeuropee
分類:Kî-chhòng	Categoria:Aeroporti
分類:Fa-ho̍k ngièn-su	Categoria:Elementi chimici
分類:Khô-ho̍k-kâ	Categoria:Scienziati
分類:Pâ-kî-sṳ̂-thán Thi-lî	Categoria:Geografia del Pakistan
分類:Nì-pok	Categoria:Nepal
分類:Thòi-vân	Categoria:Taiwan
分類:Chûng-koet chhèu-thoi	Categoria:Dinastie cinesi
分類:Pet-mî-chû koet-kâ	Categoria:Stati dell'America settentrionale
分類:Sṳ-tshòi	Categoria:Ortaggi
分類:Súi-kó	Categoria:Frutta
分類:Khiu-yok Sṳn-kîn	Categoria:Antico Testamento
分類:Pok-vu̍t-kón	Categoria:Musei
分類:Hì-hèu	Categoria:Clima
分類:Â-chû Thi-lî	Categoria:Geografia dell'Asia
分類:Ngìn-lui-ho̍k	Categoria:Antropologia
分類:Thai-khûng Chhàm	Categoria:Stazioni spaziali
分類:Fap-koet Thai-ho̍k	Categoria:Università in Francia
模板:ESP	Template:ESP
分類:Thung-vu̍t	Categoria:Animali
分類:Ngî-yîm-ho̍k	Categoria:Fonetica
分類:Hòng-khûng Kûng-sṳ̂	Categoria:Compagnie aeree
分類:Ngìn-khièn	Categoria:Diritti umani
分類:Ngo̍k-hi	Categoria:Strumenti musicali
分類:Ngî-ne	Categoria:Famiglie linguistiche
分類:Hon-sṳ	Categoria:Scrittura cinese
分類:Koet-kâ Kûng-yèn	Categoria:Parchi nazionali
分類:Hi-siong-ho̍k	Categoria:Meteorologia
分類:Chûng-mî-chû	Categoria:America centrale
分類:Hiông-kóng	Categoria:Hong Kong
分類:Kóng-sî-sén	Categoria:Guangxi
分類:Yên-liau	Categoria:Combustibili
分類:Sông-hói	Categoria:Shanghai
分類:Ngiuk-lui	Categoria:Carni e derivati
分類:Yo̍k-ho̍k	Categoria:Farmacia
分類:Sú-tû	Categoria:Capitali di stato
分類:Kham-thap-pu-lî-â	Categoria:Cantabria
分類:Â-sṳ̂-thù-lî-â-sṳ̂-sén	Categoria:Asturie
分類:Kîm-su̍k	Categoria:Metalli
分類:Thòi-pet-sṳ	Categoria:Taipei
分類:Lò-màn Ngî-chhu̍k	Categoria:Lingue romanze
分類:Kâu-thûng	Categoria:Trasporti
分類:Ngiên-kiu	Categoria:Ricerca scientifica
分類:Thông-lui	Categoria:Carboidrati
分類:Nàm-tó ngî-hì	Categoria:Lingue austronesiane
分類:Pet-mî-chû	Categoria:America settentrionale
分類:Kô-sú	Categoria:Cantanti
分類:Si-chhòng	Categoria:Tibet
分類:Sú-ho̍k-kâ	Categoria:Matematici
分類:Vu̍t-lî ho̍k-kâ	Categoria:Fisici
分類:Kîn-chi ho̍k-kâ	Categoria:Economisti
分類:Mìn-tsú	Categoria:Democrazia
分類:Kî-tuk-kau Li̍t-sṳ́	Categoria:Storia del cristianesimo
分類:Àu-mûn	Categoria:Macao
分類:Hàng-sên-ne	Categoria:Stelle con pianeti extrasolari
分類:Thòi-vân ngî-ngièn	Categoria:Lingue di Taiwan
分類:Thòi-vân Koet-kâ Kûng-yèn	Categoria:Parchi nazionali di Taiwan
分類:Ngiùn-hòng	Categoria:Banche
Fu̍k-vu	Servizio
分類:Kâ-thai-lò-nì-â	Categoria:Catalogna
Kap-kut-vùn	Scrittura sulle ossa
分類:Khien-không	Categoria:Salute
模板:Lang-pl	Template:Polacco
Trojany	Trojany
分類:Â-chû koet-kâ	Categoria:Stati dell'Asia
分類:Mî-chû koet-kâ	Categoria:Stati dell'America
模板:Chûng-fà Mìn-chhu̍k	Template:Gruppi etnici della Cina
模板:User nan-2	Template:Utente zh-min-nan-2
模板:MLT	Template:MLT
模板:User zh-classical-2	Template:Utente lzh-2
分類:Kûng-yèn	Categoria:Parchi
分類:Thòi-vân ngièn-tshu-mìn ngî-ngièn	Categoria:Lingue formosane
分類:Si-chhòng Thi-lî	Categoria:Geografia del Tibet
分類:Nui-mùng-kú Tshṳ-tshṳ-khî	Categoria:Mongolia Interna
分類:Koet-tsi kîn-tsi tsû-tsṳt	Categoria:Organizzazioni economiche internazionali
分類:Lâ-tên Mî-chû	Categoria:America Latina
分類:Siak-khiet-kau	Categoria:Sikhismo
分類:Sa-fi Mìn-tsú Tsú-ngi	Categoria:Socialdemocrazia
模板:BEL	Template:BEL
分類:Kú-thoi chhu̍k-khiùn	Categoria:Popoli antichi
分類:Vùi-sṳ̂-khà-sén	Categoria:Provincia di Huesca
分類:Thap-là-kô-na̍p-sén	Categoria:Provincia di Tarragona
分類:Pâ-set-lò-nâ-sén	Categoria:Provincia di Barcellona
分類:Pâ-lùn-sî-â-sén	Categoria:Provincia di Valencia
分類:Chûng-kau-ho̍k	Categoria:Studio delle religioni
分類:Thien-fa	Categoria:Telefonia
模板:TPE	Template:TPE
分類:Ngân-set	Categoria:Colori
分類:Â-là-kung	Categoria:Aragona
分類:Phòng-châ-phú	Categoria:Punjab
模板:Chûng-fà Mìn-koet Hàng-chṳn Khî-va̍k	Template:Suddivisioni di Taiwan
分類:Lie̍t-yî-tha̍t-sén	Categoria:Provincia di Lleida
分類:User lzh	Categoria:Utenti lzh
分類:Sat-là-kô-sat-sén	Categoria:Provincia di Saragozza
模板:HUN	Template:HUN
模板:Yin-thu-nì-sî-â	Template:Province dell'Indonesia
模板:Kóng-sî Hàng-chṳn Khî-va̍k	Template:Prefetture Guangxi
模板:Kóng-tûng Hàng-chṳn Khî-va̍k	Template:Prefetture del Guangdong
分類:User en-1	Categoria:Utenti en-1
分類:User de-1	Categoria:Utenti de-1
Liû-khiû Khiùn-tó	Ryūkyū
模板:User ru-3	Template:Utente ru-3
模板:User nl-3	Template:Utente nl-3
模板:Si-chhôn Hàng-chṳn Khî-va̍k	Template:Prefetture Sichuan
模板:Fâ-lièn-yen	Template:Contea di Hualien
2013-ngièn Lù-sân Thi-chṳ́n	Terremoto di Ya'an del 2013
Yòng-ya̍p-é	Farfalla
Chûng-koet Chhèu-thoi	Dinastie della storia cinese
模板:Ping	Template:Ping
IPhone 5S	IPhone 5s
IPhone 5C	IPhone 5C
Sûng-kú Lô-siên	Doppia elica
特殊:最近更改	Speciale:UltimeModifiche
模組:Navbox	Modulo:Navbox
馬來西亞航空17號班機空難	Volo Malaysia Airlines 17
