អាហ្វ្រិក	Africa
ជប៉ុន	Giappone
អង់គ្លេស	Inghilterra
ស្កុតឡែន	Scozia
វ៉ែល	Galles
អៀរឡង់ខាងជើង	Irlanda del Nord
សាធារណរដ្ឋអៀរឡង់	Irlanda
ប្រទេសហុងគ្រី	Ungheria
អេស្ប៉ាញ	Spagna
សហរដ្ឋអាមេរិក	Stati Uniti d'America
ផែនដី	Terra
ប៊ឺណឺស លី	Tim Berners-Lee
ស៊ុយអែត	Svezia
ប្រទេសប៉ូឡូញ	Polonia
អ៊ីតាលី	Italia
ព័រទុយហ្គាល់	Portogallo
អឺរ៉ុប	Europa
អាស៊ី	Asia
វិគីភីឌា	Wikipedia
ភីអេចភី	PHP
ទីក្រុងញូវយ៉ក	New York
កុំព្យូទ័រ	Computer
អ៊ីនធើណេត	Internet
បារ៉ាក់ អូបាម៉ា	Barack Obama
ប៉ារីស	Parigi
អាប្រាហាម លីនខូន	Abraham Lincoln
ប្រព័ន្ធប្រតិបត្តការ Android	Android
Google ស្វែងរក	Google Inc.
ម៉ិកស៊ិក	Messico
មហាសមុទ្រអាត្លង់ទិក	Oceano Atlantico
មហាសមុទ្រប៉ាស៊ីហ្វិក	Oceano Pacifico
ថ្ងៃច័ន្ទ	Lunedì
ខែមករា	Gennaio
ខែកុម្ភៈ	Febbraio
ខែមីនា	Marzo
ភពអង្គារ	Marte (astronomia)
ខែមេសា	Aprile
ខែឧសភា	Maggio
ខែមិថុនា	Giugno
ខែកក្កដា	Luglio
ខែសីហា	Agosto
ខែកញ្ញា	Settembre
ខែតុលា	Ottobre
ខែវិច្ឆិកា	Novembre
ខែធ្នូ	Dicembre
អង្គារ	Martedì
ថ្ងៃពុធ	Mercoledì
ថ្ងៃព្រហស្បតិ៍	Giovedì
ថ្ងៃសុក្រ	Venerdì
ថ្ងៃសៅរ៍	Sabato
ថ្ងៃអាទិត្យ	Domenica
សេះ (​អុក​)	Cavallo (scacchi)
បារាំង	Francia
សត្វឆ្កែ	Canis lupus familiaris
រាជាណាចក្ររួម	Regno Unito
ឆ្មា	Felis silvestris catus
ភាសាបារាំង	Lingua francese
ប្រេស៊ីល	Brasile
រុស្ស៊ី	Russia
ការ៉េ	Quadrato
សមុទ្រ	Mare
អាល្លឺម៉ង់	Germania
ភាសាអាល្លឺម៉ង់	Lingua tedesca
ប្រទេសអាយឡែន	Islanda
ភពសៅរ៍	Saturno (astronomia)
១ (លេខ)	1 (numero)
២ (លេខ)	2 (numero)
៣ (លេខ)	3 (numero)
៥	5 (numero)
ចតុកោណកែង	Rettangolo
មុំកែង	Angolo retto
អ៊ុយក្រែន	Ucraina
ទីក្រុងរ៉ូម	Roma
អាល់បានី	Albania
អាស៊ែបៃហ្សង់	Azerbaigian
អង់ដូរ៉ា	Andorra
សាធារណរដ្ឋកាហ្សាក់ស្ថាន	Kazakistan
បុរីវ៉ាទីកង់	Città del Vaticano
គុយបា	Cuba
ឥណ្ឌូនេស៊ី	Indonesia
អាហ្វ្រិកខាងត្បូង	Sudafrica
ប្រវត្តិសង្ខេប ក្រុមតន្រ្តី រ៉ុក linkin park	Linkin Park
ប្រទេសអាល់ហ្សេរី	Algeria
ស្រា	Vino
ទឹក	Acqua
ទូរទស្សន៏	Televisione
ភាសាអាយឡែន	Lingua islandese
ឈីលី	Cile
ព្រះយេស៊ូវ គ្រីស្ទ	Gesù
ភពពុធ	Mercurio (astronomia)
ប្រវត្តិសាស្ត្រ	Storia
ភពសុក្រ	Venere (astronomia)
ភាសា	Linguaggio
ភពព្រហស្បតិ៍	Giove (astronomia)
ភពអ៊ុយរ៉ានុស	Urano (astronomia)
វិគីភីឌាភាសាអង់គ្លេស	Wikipedia in inglese
ភពណិបទូន	Nettuno (astronomia)
សិង្ហបុរី	Singapore
ភ្លុយតុង	Plutone (astronomia)
ហ្វេសប៊ុក	Facebook
សង្គ្រាមលោកលើកទីមួយ	Prima guerra mondiale
សង្គ្រាមលោកលើកទី២	Seconda guerra mondiale
ទំព័រគំរូ:Corruption	Corruzione
Ubuntu	Ubuntu
លីនុច	Linux
គណិតវិទ្យា	Matematica
បារ៉ែន	Bahrein
ព្រះចន្ទ	Luna
អូស្ត្រាលី	Australia
រូបវិទ្យា	Fisica
ជីវវិទ្យា	Biologia
កូរ៉េខាងជើង	Corea del Nord
ព្រះរាជាណាចក្រកម្ពុជា	Cambogia
ឌីណូស័រ	Dinosauria
សាសនាឥស្លាម	Islam
សេរីភាព	Pace
សហភាពអឺរ៉ុប	Unione europea
ចេក	Banana
ណាប៉ូលេអុងបូណាប៉ារត៍	Napoleone Bonaparte
ព្រះអាទិត្យ	Sole
ឆ្នាំពន្លឺ	Anno luce
អូសេអានី	Oceania
ប្រព័ន្ធព្រះអាទិត្យ	Sistema solare
អុីដ្រូសែន	Idrogeno
ទីម័រខាងកើត	Timor Est
ម៉ុង ប្លុង	Monte Bianco
សឺរេស	Cerere (astronomia)
អៀរីស	Eris (astronomia)
ភព	Pianeta
តន្ត្រី	Musica
ភាសាអ៊ីតាលី	Lingua italiana
អាលុយមីញ៉ូម	Alluminio
នូវែលសេឡង់	Nuova Zelanda
ឥណ្ឌា	India
អង់ដ្រេ ម៉ារី អំពែរ	André-Marie Ampère
វីលីម ហ្សេកស្ពែរ	William Shakespeare
ប៉ាឡាវ	Palau (stato)
ម៉ុងហ្គោលី	Mongolia
ជេនហ្គិស ខាន់	Gengis Khan
កូឡុំប៊ី	Colombia
ព្រះពុទ្ធសាសនា	Buddhismo
ហ្គាតេម៉ាឡា	Guatemala
មហាសមុទ្រអាកទិក	Mar Glaciale Artico
អ៊ីរ៉ង់	Iran
ភាសាប៉ូឡូញ	Lingua polacca
ហ្សកដង់	Giordania
កៀហ៊្សីស៊ីស្ថាន	Kirghizistan
គុយវ៉ែត	Kuwait
ឡាវ	Laos
លីបង់	Libano
ទ្វីបអាមេរិក	America
ម៉ាឡេស៊ី	Malesia
មីយ៉ាន់ម៉ា	Birmania
នេប៉ាល់	Nepal
ប៉ាគីស្ថាន	Pakistan
MySQL	MySQL
អារ៉ាប៊ីសាអូឌីត	Arabia Saudita
ស្រីលង្កា	Sri Lanka
ផ្លាតូ	Platone
តាជីគីស្ថាន	Tagikistan
YouTube	YouTube
អារីស្តូត	Aristotele
ថៃ	Thailandia
វិទ្យុ	Radio (elettronica)
តួរមិនីស្ថាន	Turkmenistan
វៀតណាម	Vietnam
កូរ៉េខាងត្បូង	Corea del Sud
សាធារណរដ្ឋឥស្លាមអាហ្វហ្កានីស្ថាន	Afghanistan
ព្រែកជីកស៊ុយអែស	Canale di Suez
បង់ក្លាដែស្ស	Bangladesh
សូក្រាត	Socrate
ធ្វិតថឺរ	Twitter
ប៊្រុយណេ	Brunei
ហ្វីលីពីន	Filippine
អ៊ីសាក់ ញូតុន	Isaac Newton
OpenStreetMap	OpenStreetMap
អាល់បឺត អែងស្តែង	Albert Einstein
ប្រទេសហ្សំប៊ី	Zambia
ប៉េកាំង	Pechino
មហាត្មះគន្ធី	Mahatma Gandhi
ឆាលែស ដាវីន	Charles Darwin
ជូលីស៍ សេសារ	Gaio Giulio Cesare
ឥន្ទធនូ	Arcobaleno
អង្គការសហប្រជាជាតិ	Organizzazione delle Nazioni Unite
ភូមិវិទ្យា	Geografia
ទីក្រុងប្រាក	Praga
បន្ទុកអគ្គីសនី	Carica elettrica
ខេត្តជើងភ្នំ (ប្រទេសអ៊ីតាលី)	Piemonte
មហាសមុទ្រឥណ្ឌា	Oceano Indiano
អូសាម៉ា ប៊ីន ឡាឌែន	Osama bin Laden
ភាសាអេស្ប៉ាញ	Lingua spagnola
ភីឡាដេលផ្យា	Filadelfia (Stati Uniti d'America)
ញូវយ៉ក	New York (Stato)
វ្លាឌីមៀរ អ៊ីលីច លេនីន	Lenin
អូហ្គុសទុស	Augusto
លោកកៃយុសសេសារ	Caligola
ត្រាហ្សាន	Traiano
Kde	KDE
កូរ៉ាស៊ូន អាគីណូ	Corazón Aquino
ទីក្រុងតូខ្យូ	Tokyo
ហ្វឺឌីណាន់ដ៏ ម៉ាហ្សេឡង់	Ferdinando Magellano
ស៊ីសេរ៉ូ	Marco Tullio Cicerone
ភ្នំពេញ	Phnom Penh
ទីក្រុងព្រៃនគរ	Ho Chi Minh (città)
ទីក្រុងហានូយ	Hanoi
គ្រិស្តសាសនា	Vera Chiesa di Gesù
ភាសាអង់គ្លេស	Lingua inglese
គូឡាឡាំពួ	Kuala Lumpur
២០០១	2001
JavaScript	JavaScript
HTML5	HTML5
ល្បឿនពន្លឺ	Velocità della luce
JPEG	JPEG
អេឡិចត្រុង	Elettrone
ចក្រភព រ៉ូម	Impero romano
Microsoft	Microsoft
គីមីវិទ្យា	Chimica
ស៊ីទ្រុងជ្រូក	C sharp
បេណេឌីកទី១៦	Papa Benedetto XVI
៧ កក្កដា	7 luglio
បាល់ទាត់	Calcio (sport)
ទីក្រុងបូកូតា	Bogotá
ថ្ងៃទី៣១ខែធ្នូ	31 dicembre
រិសថា	4 Vesta
ស៊ីដនីយ៏	Sydney
ភ្លើង	Fuoco
ខ្យល់	Atmosfera terrestre
កោះស៊ូម៉ាត្រា	Sumatra
ចាការតា	Giacarta
ចំណាត់ថ្នាក់ក្រុម:Wikipedia templates	Categoria:Template
កោះជ្វា	Giava
ចំណាត់ថ្នាក់ក្រុម:ចំណាត់ថ្នាក់ក្រុមនៃទំព័រគំរូវិគីភីឌា	Categoria:Template per tema
កាលីម៉ាន់តាន់	Kalimantan
ខេត្តបន្ទាយមានជ័យ	Provincia di Banteay Meanchey
វិគីភីឌា:ប្រអប់ខ្សាច់	Wikipedia:Pagina delle prove
អាកាសយានដ្ឋាន ដុង ហ៊យ	Aeroporto di Dong Hoi
អាន់ ហ្វ្រែង	Anna Frank
ខុង ជឺ	Confucio
ម៉ារីលីន ម៉ុនរ៉ូ	Marilyn Monroe
ចំណាត់ថ្នាក់ក្រុម:គណិតវិទ្យា	Categoria:Matematica
ចំណាត់ថ្នាក់ក្រុម:ប្រវត្តិសាស្ត្រខ្មែរ	Categoria:Storia della Cambogia
សមុទ្រ មេឌីទែរ៉ានេ	Mar Mediterraneo
វីនដូអេច	Windows 8
ទំព័រគំរូ:ប្រទេសនៅទ្វីបអាស៊ី	Template:Asia
ទំព័រគំរូ:Agree	Template:Favorevole
ទន្លេហ្គារ៉ូន	Garonna
ស៊ីតថល	Seattle
ជញ្ជាំង ប៊ែរឡាំង	Muro di Berlino
ទំព័រគំរូ:Lang-tr	Template:Turco
ទំព័រគំរូ:ផតថល	Template:Portale
ប៊ីល ហ្គេត	Bill Gates
ភាសាជប៉ុន	Lingua giapponese
ប្រជុំវីជ្ជា	Enciclopedia
ឌីវីឌី	DVD
ទំព័រដើម	Pagina principale
Central processing unit	CPU
រេស៊ីស្ទ័រ	Resistore
កីឡាអូឡាំពិក	Giochi olimpici
សមុទ្រ កាសព្យែន	Mar Caspio
ឈី ហ្គីវ៉ារ៉ា	Che Guevara
ទីក្រុងកាបូល	Kabul
ហ្គ្រាប្រីអ៊ែល ហ្រ្គារ៉ាស្សៀ ម៉ារ៉ាហ្គេស	Gabriel García Márquez
ទស្សនវិជ្ជា	Filosofia
ចំណាត់ថ្នាក់ក្រុម:លុប	Categoria:Cancellare subito
លិទ្ធិកុម្មុយនិស្ត	Comunismo
ហ៊ីលឡារី រូដហេម គ្លីនតុន	Hillary Clinton
Boeing 737	Boeing 737
អាហារនៅប្រទេសបារំាង និង របៀបធ្វើ	Cucina francese
មណ្ឌលម៉ាញេតូ	Magnetosfera
UTC+7	UTC+7
ភាសាកាតាឡាន	Lingua catalana
បណ្ណាល័យ	Biblioteca
នីល ហេនរីក ដេវីដ ប៊័រ	Niels Bohr
និវេសនវិទ្យា	Ecologia
ក្លឹបបាល់ទាត់បារសេឡូណា	Futbol Club Barcelona
នយោបាយ	Politica
ធនាគារពិភពលោក	Banca Mondiale
ប្រជាធិបតេយ្យ	Democrazia
អង្គការសន្ធិសញ្ញាអាត្លង់ទិកខាងជើង	Organizzazione del Trattato dell'Atlantico del Nord
ម៉ារី ស្កូដូស្កា គុយរី	Marie Curie
រង្វាន់ណូបែល	Premio Nobel
មជ្ឈិមបូព៌ា	Medio Oriente
រាជវង្សហាន	Dinastia Han
ប្រទេស	Stato
គ្រឹស្តុបផើ កូឡំបូស (Christopher Columbus)	Cristoforo Colombo
ព្រែកជីកប៉ាណាម៉ា	Canale di Panama
មហាសមុទ្រខាងត្បូង	Oceano antartico
ត្រីផ្សោតនៅកម្ពុជា	Delfino
ក្មេង	Bambino
លេអុនហាដ អយល័រ	Eulero
ណាប៉ូលេអុងទី៣	Napoleone III di Francia
ភាសារុស្ស៊ី	Lingua russa
ល្វី ដ៏អស្ចារ្យ	Luigi XIV di Francia
សមាគមប្រជាជាតិអាស៊ីអាគ្នេយ៍	Associazione delle Nazioni del Sud-est asiatico
ប្រវត្តិសាស្ត្របារាំង	Storia della Francia
តុលាការយុត្តិធម៌អន្តរជាតិ	Corte internazionale di giustizia
យូណេស្កូ	Organizzazione delle Nazioni Unite per l'Educazione, la Scienza e la Cultura
អង្គការសុខភាពពិភពលោក	Organizzazione mondiale della sanità
អង្គការពាណិជ្ជកម្មពិភពលោក	Organizzazione mondiale del commercio
ភាសាចិន	Lingua cinese
ធម្មជាតិ	Natura
ឈាម	Sangue
រញ្ជួយផែនដី	Terremoto
សមុទ្រឡាប់តែវ	Mare di Laptev
ភ្លើងចរាចរ	Semaforo
ម៉ាទីន ឡូតធឺរ ឃីង	Martin Luther King
ត្រីកោណមាត្រ	Trigonometria
ធរណីមាត្រ	Geometria
វេយ្យាករណ៍	Grammatica
សេដ្ឋកិច្ច	Economia
អក្សរក្រិច	Alfabeto greco
អក្សរឡាតាំង	Alfabeto latino
រឿងមហាភារតយុទ្ធ	Mahābhārata
ការិយាល័យសហព័ន្ធស៊ើបអង្កេត	Federal Bureau of Investigation
វីយោឡុង	Violino
ឃឹម	Cimbalom
អេឡិចសាន់ដឺ ដឹ ហ្គារ៉ែត	Alessandro Magno
សង្គម	Società (sociologia)
ការអប់រំ	Educazione
មនុស្សប្រុស	Uomo (genere)
វិគីភីឌាភាសាអេស៉្បាញ	Wikipedia in spagnolo
សិទ្ធិមនុស្ស	Diritti umani
ទាសភាព	Schiavismo
សង្គ្រាមស៊ីវិល	Guerra civile
ភ្នំ	Montagna
ហុងកុង	Hong Kong
សង្គ្រាមត្រជាក់	Guerra fredda
សេអ៊ូល	Seul
សង្គ្រាមវៀតណាម	Guerra del Vietnam
ម៉ៃឃើល ហ្វារ៉ាដេយ	Michael Faraday
អង់រីកូ ហ្វែរមី	Enrico Fermi
ភាសាអ៊ុយក្រែន	Lingua ucraina
HTML	HTML
ច្យូហានេស គូទេនបឺគ	Johannes Gutenberg
ភាសាដាណឺម៉ាក	Lingua danese
ភាសាអេស្តូនី	Lingua estone
ហិណ្ឌូសាសនា	Induismo
ភាសាពែក	Lingua persiana
សាសនា	Religione
ភាសាកូរ៉េ	Lingua coreana
ភាសាខ្មែរ	Lingua khmer
ហ្រ្គេតស៊ីងមួន	Sigmund Freud
ភាសាថៃ	Lingua thailandese
ភាសាម៉ាឡេ	Lingua malese
ភាសាឥណ្ឌូនេស៊ី	Lingua indonesiana
ភាសាហេប្រ៊ូ	Lingua ebraica
ចន ឡុក	John Locke
ថ្លើម	Fegato
ចិត្តវិទ្យា	Psicologia
មហាសមុទ្រ	Oceano
ពុទ្ធប្រវត្តិសង្ខេប	Gautama Buddha
ចរិយាមារយាទ	Etica
សារជីវកម្មផ្សព្វផ្សាយព័ត៌មានរបស់ចក្រភពអង់គ្លេស(BBC)	BBC
ក្លិបបាល់ទាត់ឆេលស៊ី	Chelsea Football Club
គ្រោងឆ្អឹងមនុស្ស	Scheletro (anatomia umana)
ក (អវយវៈ)	Collo
រាជវង្សថាង	Dinastia Tang
John F. Kennedy	John Fitzgerald Kennedy
LibreOffice	LibreOffice
ផ្លូវរូងដីក្រោមសមុទ្រ	Tunnel della Manica
តារាងខួបនៃធាតុគីមី	Tavola periodica degli elementi
ប្រូម៉ាស	Formaggio
ទំពាំងបាយជូរ	Uva
បន្លែ	Verdura
បច្ចេកវិទ្យា	Tecnologia
វិស្វកម្ម	Ingegneria
ទំនាក់ទំនង	Comunicazione
វិជ្ជាជីវៈខាងសារព័ត៌មាន	Giornalismo
កាសែត	Giornale
ទូរស័ព្ទ	Telefono
វប្បធម៌	Cultura
សំស្ក្រឹត	Lingua sanscrita
ប្រដាប់របត់ឈាម	Apparato circolatorio
The Guardian	The Guardian
សមីការឌីផេរ៉ង់ស្យែល	Equazione differenziale
មៃក្រូសូហ្វអ៊ិសេល	Microsoft Excel
មុំ	Angolo
សំទុះ	Accelerazione
ព្រះសិវៈ	Shiva
ព្រះវិស្ណុ	Vishnu
Local Area Network	Local Area Network
Wide Area Network	Wide Area Network
ព្រះព្រហ្ម	Brahma
កម្លាំង	Forza
កសិកម្ម	Agricoltura
សំលៀកបំពាក់	Abbigliamento
ល្បឿន	Velocità
ក្រដាស	Carta
សុញ្ញកាស	Vuoto (fisica)
ស៊ីនេម៉ាទិច	Cinematica
ក្រលាផ្ទៃ	Area
ទ្រឹស្តីបទពីតាករ	Teorema di Pitagora
ចំនួនកុំផ្លិច	Numero complesso
Cristiano Ronaldo	Cristiano Ronaldo
អ្នកថតរូប	Fotografia
ល្ខោន	Teatro
គ្រឿងអេឡិចត្រូនិច	Componente elettronico
អាស៊ីអាគ្នេយ៍	Sud-est asiatico
ក្រុងសៀមរាប	Siem Reap
បញ្ជីរាយនាម ប្រទេស	Stati del mondo
វិគីភីឌាភាសាព័រទុយហ្គាល់	Wikipedia in portoghese
ប្រដាប់រំលាយអាហារ	Digestione
កីឡាចាក់សាប	Scherma
រោគផ្ដាសាយធម្មតា	Raffreddore comune
រោគសរសៃប្រសាទ	Disturbo mentale
ប្រតិទិន ក្រេកូរី	Calendario gregoriano
សុខភាព	Salute
ជម្ងឺរលាកទងសួត	Polmonite
ជំងឺអេដស៍	AIDS
កូដ QR	Codice QR
ជំងឺទឹកនោមផ្អែម	Diabete mellito
ទំព័រគំរូ:Location map Belgium	Template:Mappa di localizzazione/BEL
ទំព័រគំរូ:Location map Croatia	Template:Mappa di localizzazione/HRV
ទំព័រគំរូ:Location map Ukraine	Template:Mappa di localizzazione/UKR
ទំព័រគំរូ:Location map Burma	Template:Mappa di localizzazione/MMR
ទំព័រគំរូ:Location map Philippines	Template:Mappa di localizzazione/PHL
ទំព័រគំរូ:Location map Vietnam	Template:Mappa di localizzazione/VNM
ទំព័រគំរូ:Location map Cambodia	Template:Mappa di localizzazione/KHM
ទំព័រគំរូ:Location map Thailand	Template:Mappa di localizzazione/THA
ទំព័រគំរូ:Location map Indonesia	Template:Mappa di localizzazione/IDN
ទំព័រគំរូ:Location map Australia	Template:Mappa di localizzazione/AUS
ញូតុន	Newton (unità di misura)
ចក្រភព អូតូម៉ង់	Impero ottomano
ម៉ាស៊ីនចំហេះក្នុង	Motore a combustione interna
ក្បាច់គិតលេខ	Abaco
វឺតប្រែស	WordPress
Joomla!	Joomla!
ដើមដូង	Cocos nucifera
ភាសាណាវ៉ាថ្ល៍	Lingua nahuatl
ភាសាម៉ាយ៉ាយូកាតិក	Lingua maya yucateca
អែនជេលីណា ចូលី	Angelina Jolie
អ៊ីលដឺហ្រ្វែន	Île-de-France
ភាសាអារ៉ាប់	Lingua araba
Thanksgiving	Giorno del ringraziamento
តំបន់ឃ្ជឺស្សឺ	Kyūshū
តំបន់ស៊ីកុគឹ	Shikoku
នាយករដ្ឋមន្ត្រី	Primo ministro
ទង់ជាតិ	Bandiera
ខ្មៅដៃ	Matita
សហភាពសូវៀត	Unione Sovietica
ចំណុចរលាយ	Punto di fusione
កាមេរ៉ា	Fotocamera
កម្មវិធីទូរទស្សន៍	Programma televisivo
ខេត្តខាហ្គុស៊ីម៉ា	Prefettura di Kagoshima
ភាសាស៊ី	C (linguaggio)
ម៉ង់តេរីយើ	Montesquieu
វិគីភីឌា:អត្ថបទពិសេស	Wikipedia:Vetrina
ទំព័រគំរូ:Link FA	Template:Link V
ពិភពលោក	Mondo
ឈូក	Nelumbo nucifera
ឡងប៊ិច (កាលីផ្វនញ៉ា)	Long Beach (California)
រង្វង់	Circonferenza
ប្លង់	Piano (geometria)
វិគីភីឌាភាសាកូរ៉េ	Wikipedia in coreano
ទៀបកោះម៉ាឡេ	Penisola malese
អេប៉ុងហ្ស៍ (ពពុះទឹក)	Porifera
World Cup	Campionato mondiale di calcio
សម្ដេចប៉ាប	Papa
IATA	International Air Transport Association
បុណ្យណូអែល	Natale
ត្រីកោណ	Triangolo
លោកអេលីសេ រីខ្លាស	Élisée Reclus
អ្នកប្រើប្រាស់:អេង ឡុង/សង្គមវិទ្យាមូលដ្ឋាន	Sociologia
សញ្ញាសំលេងអន្តរជាតិ	Alfabeto fonetico internazionale
តៃវ៉ាន់	Isola di Formosa
Friedrich Schiller	Friedrich Schiller
ជំនឿបាហៃ	Bahá'í
១	1
អាប្រាហាម ម៉ាស្លូ	Abraham Maslow
ខ្ទឹមស	Allium sativum
អ៊ូលេនបាធរ	Ulan Bator
កោះ	Isola
ភាសាផ្លូវការ	Lingua ufficiale
ខ្សែអេក្វាទ័រ	Equatore
ទិស	Punto cardinale
លេខអាតូម	Numero atomico
អាល់ហ្វ្រិដ ណូបែល	Alfred Nobel
សម្ដេចប៉ាប យូហាន ទី២៣	Papa Giovanni XXIII
កិរិយាសព្ទ	Verbo
ទីតានិច	RMS Titanic
សត្វឆ្អឹងកង	Vertebrata
បាគូ	Upupa epops
អំពែរ	Ampere
ISO 3166-1	ISO 3166-1
១ មុនគ.ស	1 a.C.
ម៉ែត្រការ៉េ	Metro quadrato
ជំនួយ:Interlanguage links	Plancton
សហស្សវត្សរ៍ទី២	II millennio
ខេត្តកំពង់គោ	Provincia di Long An
ទ្រឹស្តីបទទ្វេធា	Teorema binomiale
សមុទ្រជប៉ុន	Mar del Giappone
អាស៊ីខាងកើត	Asia orientale
អាមេរិក កណ្ដាល	America Centrale
គ្រីស្ទអឌែលហ្វៀន	Cristadelfiani
បរិមាត្រ	Perimetro
ចក្រភព អូទ្រីស-ហុងគ្រី	Impero austro-ungarico
ផាយថុន	Python
អានន្ទ	Ananda (monaco)
អាស៊ីហ្គេមឆ្នាំ១៩៥១	I Giochi asiatici
បាកាន	Bagan
សំទុះទំនាញដី	Accelerazione di gravità
ច្បាប់ធម្មតា	Common law
អ្នកម្តាយ តេរេសា​ (Mother Teresa)	Madre Teresa di Calcutta
ប្លូក	Blog
រោគគ្រុនចាញ់	Dengue
ដុល្លារហុងកុង	Dollaro hongkonghese
ខ្សែបណ្ដោយ	Meridiano
ខេត្តឃ្លាំង	Provincia di Soc Trang
ខេត្តទឹកខ្មៅ	Provincia di Cà Mau
សមុទ្រខារ៉ា	Mare di Kara
ផ្លេតបន្ទោរ	Fulmine
កំរងកោះ	Arcipelago
តួប្រុស	Attore
អំបូរភាសាយូតូអាហ្សតិក	Lingue uto-azteche
ចាស្ទីន ពីពេ្រ	Justin Bieber
ក្រុម​ភាសា​ថៃកៈដៃ	Lingue tai-kadai
ចក្រភព រុស្ស៊ី	Impero russo
មឞវជ	Mošovce
បេណាហ្សៀរ ប៊ូតូ	Benazir Bhutto
ស៊ីឌី	Compact disc
ឧទ្ធម្ភាគចក្រ	Elicottero
គុណនាម	Aggettivo
វីតាមីន	Vitamine
វែបសាយ	Sito web
តំបន់ហុកកៃដូ	Hokkaidō
រូបមន្តសមមូលម៉ាស់-ថាមពល	E=mc²
សមុទ្រ អារ៉ាល់	Lago d'Aral
ហូ ជីមិញ	Ho Chi Minh
ម៉ាក ហ្សុកឃឺបឺក	Mark Zuckerberg
ប្រតិកម្មគីមី	Reazione chimica
ខេត្តក្រមួនស	Provincia di Kien Giang
ខេត្តមាត់ជ្រូក	Provincia di An Giang
ខេត្តរោងដំរី	Provincia di Tay Ninh
ខេត្តព្រះត្រពាំង	Provincia di Tra Vinh
Binomial nomenclature	Nomenclatura binomiale
ខេត្តពលលាវ	Provincia di Bac Lieu
ខេត្តផ្សារដែក	Provincia di Dong Thap
វ៉ែសបែង	Cisgiordania
ភាសាបាលី	Lingua pāli
គេហទំព័រ	Pagina web
ចតុកោណ	Quadrilatero
ឈិន ឡុង	Jackie Chan
Yahoo!	Yahoo!
បន្ទាត់	Retta
ហ្មរិឩពឡ	Mariupol'
G8	G8
អង្កត់ផ្ចិត	Diametro
គ្រូបង្រៀន	Docente
ស្នាដៃនៃបុព្វបុរសខ្មែរ	Scrittura
ស្ដេចប៉ាប យ៉ូហាន ប៉ូលទី១	Papa Giovanni Paolo I
ណៃពិដោ	Naypyidaw
ISO 4217	ISO 4217
ព្យែរ គុយរី	Pierre Curie
ក្រុមប្រឹក្សាសន្តិសុខ អង្គការសហប្រជាជាតិ	Consiglio di sicurezza delle Nazioni Unite
ពហុកោណ	Poligono
ទិវានៃក្ដីស្រលាញ់	San Valentino (festa)
ហ្គូហ្គល	Mercato
សមុទ្រចិនខាងត្បូង	Mar Cinese Meridionale
និវេសនប្រព័ន្ធ	Ecosistema
សមុទ្រលឿង	Mar Giallo
យ៉ាំងហ្គូន	Yangon
សូរព្យញ្ជនៈ	Consonante
ច្បាប់ចលនារបស់ញូតុន	Principi della dinamica
ឈូងសមុទ្របេងហ្គាល់	Golfo del Bengala
ទិវានារីអន្តរជាតិ	Giornata internazionale della donna
.jp	.jp
ភ្នំហ្វឹជី	Monte Fuji
ប៉ុលពត	Pol Pot
Xian H-6	Xian H-6
Chengdu J-7	Chengdu J-7
Shenyang J-8	Shenyang J-8
ភ្នំភ្លើង អ៊ីស៊ាឡឺក	Eyjafjallajökull
ម៉ាក្រូសេដ្ឋកិច្ច	Macroeconomia
Harbin SH-5	Harbin SH-5
ដីជ្រោយហ្គាស្សា	Striscia di Gaza
​វិទ្យុ​ស្ទូឌីយោ 54 បណ្តាញ	Radio Studio 54 Network
អេលីប	Ellisse
សមាគមន៍សារព័ត៌មាន	Associated Press
អធិដ្ឋាន	Preghiera
គណៈកម្មាធិការអូឡាំពិកអន្តរជាតិ	Comitato Olimpico Internazionale
Skype	Skype
.kh	.kh
ចតុកោណស្មើ	Rombo (geometria)
ទន្លេមេគង្គ	Mekong
មេកានិច	Meccanica (fisica)
វិចិត្រសាលវលញ្ឆករប្រទេស	Stemmi nazionali
ហែងរីហ ហឺត	Heinrich Rudolf Hertz
អង់រី បិកកឺរ៉ែល	Antoine Henri Becquerel
ទស្សនាវដ្ដី	Rivista
សមីការដឺក្រេទី២	Equazione di secondo grado
រូពីឥណ្ឌូនេស៊ី	Rupia indonesiana
សមុទ្រអុកហុតស្គ៍	Mare di Ochotsk
ចិត្តវិភាគ	Psicoanalisi
ខ្មែរម៉ាស្ទើ	Webmaster
.kr	.kr
URL	Uniform Resource Locator
ក្រុមបាល់ទាត់ជម្រើសជាតិ អេស្ប៉ាញ	Nazionale di calcio della Spagna
Google Earth	Google Earth
ប៊ែនហាដ រីម៉ាន	Bernhard Riemann
កោន	Cono
អាតុល	Atollo
ទិន្នន័យ	Dato
ខ្លែង	Aquilone
ស្ថាបត្យករ	Architetto
មហាអំណាច អាប់ស៊ីស	Potenze dell'Asse
វិគីភីឌា:FAQ	Aiuto:FAQ
.th	.th
ចក្រភព អាល្លឺម៉ង់	Impero tedesco
ក្រុមបាល់ទាត់ជម្រើសជាតិ អាល្លឺម៉ង់	Nazionale di calcio della Germania
ហេរី ផោតធ័រ និង សិលាទេព	Harry Potter e la pietra filosofale
អង្គការ Creative Commons	Creative Commons
ឥណ្ឌូចិន	Indocina
ប្រាសាទអង្គរវត្ត	Angkor Wat
ទ្រឹស្ដីរ៉ឺឡាទីវីតេ	Teoria della relatività
ប្រុស	Maschio (biologia)
Toulon	Tolone
ប៉ាស្កាល់	Pascal (unità di misura)
ទ្រឹស្ដីល្បែង	Teoria dei giochi
នីតិរដ្ឋ	Rule of Law
សមុទ្រចិនខាងកើត	Mar Cinese Orientale
ខ្នុរ	Artocarpus heterophyllus
ប្រលេឡូក្រាម	Parallelogramma
ប្រាសាទព្រះវិហារ	Tempio Preah Vihear
ចតុកោណព្នាយ	Trapezio (geometria)
ស៊ូស៊ី	Sushi
រូប៊ិក ខ្យូប	Cubo di Rubik
កាល	Tito Maccio Plauto
ចង្រិត	Gryllidae
ទិវាពលកម្មអន្ដរជាតិ	Festa del lavoro
ស្ទឹង	Ruscello
សមុទ្រអង់ដាម៉ង់	Mare delle Andamane
ប៉ិបស៊ី	Pepsi-Cola
ក្រុមបាល់ទាត់ជម្រើសជាតិ អង់គ្លេស	Nazionale di calcio dell'Inghilterra
ក្រុមបាល់ទាត់ជម្រើសជាតិ បារាំង	Nazionale di calcio della Francia
ទំព័រគំរូ:Commonscat	Template:Commonscat
វិគីភីឌាភាសាអាល្លឺម៉ង់	Wikipedia in tedesco
អាស៊ីខាងលិច	Vicino Oriente
យេនឌ័រ	Identità di genere
អង្គការសហភាពអន្តរជាតិដើម្បីអភិរក្សធម្មជាតិ	Unione Internazionale per la Conservazione della Natura
ទីក្រុងមេឌេយីណ	Medellín (Colombia)
ប៉ារ៉ាបូល	Parabola (geometria)
ខេត្តអ៊ីវ៉ាតិ	Prefettura di Iwate
ទ្វារសមុទ្រមលក្កា	Stretto di Malacca
មហាយាន	Buddhismo Mahāyāna
ប្រព័ន្ធប្រតិបត្តការ iOS	IOS (Apple)
ចំនួនបឋម	Numero primo
សង្គ្រាម ប្រាំមួយ ថ្ងៃ	Guerra dei sei giorni
ក្រុងឡូវែល រដ្ឋម៉ាស្សាឈូស៊ែត	Lowell (Massachusetts)
សមុទ្រជ្វា	Mar di Giava
សិប្បកម្មខ្ញុំ	Minecraft
ច្រកសមុទ្រធ្ងន់ធ្ងរ	Dire Straits
វីហ្សួលបេហ៊្សិក.ណេត	Visual Basic .NET
បំណែងចែករដ្ឋបាលនៃកម្ពុជា	Suddivisioni della Cambogia
ច្បាប់អំពែរ	Legge di Ampère
ជំងឺអ៊ីបូឡា	Malattia da virus Ebola
ច្រកកូរ៉េ	Stretto di Corea
ឆកសមុទ្រកូរ៉េ	Baia di Corea
កង្កែប	Anura
ខ្សែទឹកឃឹរ៉ុស៊ីអុ	Corrente Kuroshio
ចំណាត់ថ្នាក់ក្រុម:ព្រះមហាក្សត្រ	Categoria:Sovrani
ចំណាត់ថ្នាក់ក្រុម:រដ្ឋាភិបាល	Categoria:Governo
ទន្លេយ៉ាលូ	Fiume Yalu
ទំព័រគំរូ:ប្រវត្តិសាស្ត្រចិន	Template:Storia della Cina
ទំព័រគំរូ:ប្រវត្តិសាស្ត្រអាស៊ី	Template:Storia stati dell'Asia
មីហ្គេល អ៊ីដាលហ្គោ អ៊ី កុស្ទីយ៉ា	Miguel Hidalgo y Costilla
នរោត្តម សីហមុនី	Norodom Sihamoni
ហ៊ុន សែន	Hun Sen
តូក្យូស្កាយទ្រី	Tokyo Sky Tree
ភាសាប៉ាស្តូ	Lingua pashtu
ធនាគារកណ្ដាល	Banca centrale
Pidgin	Pidgin (software)
​វិលហែម វុឌ	Wilhelm Wundt
យិដា តាដូ	Gerda Taro
មនុស្សពីងពាង	Uomo Ragno
សារធាតុគីមី	Sostanza pura
ចលនានៅក្នុងរូបវិទ្យា	Moto (fisica)
ជម្ងឺកញ្ជ្រឹល	Morbillo
ក្រុមបាល់ទាត់ជម្រើសជាតិ អាហ្សង់ទីន	Nazionale di calcio dell'Argentina
ខ្យល់ព្រះអាទិត្យ	Vento solare
បាល់ទាត់ពិភពលោក ២០១៤	Campionato mondiale di calcio 2014
ម៉ូបាល (អាល់ឡាបាម៉ា)	Mobile (Alabama)
កុំព្យូទ័រផ្រូក្រាមមីង(Computer programming)	Programmazione (informatica)
ខេត្តឈីបា	Prefettura di Chiba
អាំងតេក្រាល	Integrale
ខេត្តអៃឈិ	Prefettura di Aichi
វិបត្តិសេដ្ឋកិច្ចឆ្នាំ ១៩៩៧	Crisi finanziaria asiatica
ខ្មែរ	Adulto
សិល្បៈប្រើវោហារបង្ហូរគំនិត	Retorica
ឃីមីហ្គាយ៉ុ	Kimi ga yo
សាល អូហ្គុស្ទីន ដឺ គូឡុំ	Charles Augustin de Coulomb
ខេត្តអាគីតា	Prefettura di Akita
ថ្នាក់ពាក្យ	Parti del discorso
ស្ថានភាពអភិរក្ស	Stato di conservazione (biologia)
កាន់ជិ	Kanji
ប្រវត្តិសាស្ត្រចិន	Storia della Cina
អវតារ	Avatāra
ច្បាប់គូឡុំ	Forza di Coulomb
រឿង រ៉ូមេអូ និង ហ្ស៊ុយលីយេ	Romeo e Giulietta
សាលីណា កូមាស់	Selena Gomez
ក្រុម (តារាងខួបនៃធាតុគីមី)	Gruppo della tavola periodica
ក្រុមបាល់ទាត់ជម្រើសជាតិ ប្រេស៊ីល	Nazionale di calcio del Brasile
ទ្រឹស្ដីគមនាគមន៍	Teoria della comunicazione
កាល ឡែមស្ដែនណឺ	Karl Landsteiner
បាល់ប៉ូឡូញ	Polandball
ឯកសារភាពយន្ត	Documentario
អនុគមន៍ត្រីកោណមាត្រ	Funzione trigonometrica
ហ្រាន្ដកូស ហ្វីឡុន	François Fillon
ខួប (តារាងខួបនៃធាតុគីមី)	Periodo della tavola periodica
ល្បែងទាញព្រ័ត្រ	Tiro alla fune
Article (grammar)	Articolo (linguistica)
មេដ្យានទ័រ	Compasso (strumento)
Rfid	Radio-frequency identification
អ៊ីប៉ូតេនុស	Ipotenusa
ហិចហ្វាន់	Fondo speculativo
ISO 3166	ISO 3166
សញ្ញាជាតិកូរ៉េខាងជើង	Emblema della Corea del Nord
មេហ្គា	Mega
គីឡូ	Chilo (prefisso)
ការតាំងសមាធិ	Meditazione
ប៉េតា	Peta (prefisso)
យ៉ុតតា	Yotta
សង់ទី	Centi (prefisso)
ហ្គីហ្គា	Giga (prefisso)
តេរ៉ា	Tera (prefisso)
ហ្វង់តូ	Femto
ហ្សិតតា	Zetta
ច្រកតារតារី	Stretto dei Tartari
ហ្សិបតូ	Zepto
កាតែត	Cateto
អាត់តូ	Atto (prefisso)
យ៉ុកតូ	Yocto
ដេស៊ី	Deci
ចំណែករដ្ឋបាលនៃម៉ិចស៊ិក	Suddivisioni del Messico
ម៉ាស៊ីនស្វែងរក	Metamotore
អាំងតេក្រាលមិនកំនត់	Primitiva (matematica)
Shenyang J-15	Shenyang J-15
គណបក្សហ៊្វុនស៊ិនប៉ិច	Funcinpec
ខេត្តក្យូតុ	Prefettura di Kyoto
តំលៃដាច់ខាត	Valore assoluto
ហេដ្ឋារចនាសម្ព័ន្ធ	Infrastruttura
សាស្ត្រាចារ្យ	Professore
តេគីឡា	Tequila
សន្ធិសញ្ញាប្រេស្ត-លីតូវស្ក	Trattato di Brest-Litovsk
William Thomson, 1st Baron Kelvin	William Thomson
អាណាខេត្តអូសាកា	Prefettura di Osaka
ខេត្តអិហ៊ីមិ	Prefettura di Ehime
វាំងននដែក	Cortina di ferro
Kara (band)	Kara (gruppo musicale)
វីលៀម ជែម	William James
ខេត្តយ៉ាម៉ាកាតា	Prefettura di Yamagata
ច្រកតៃវ៉ាន់	Stretto di Formosa
គំរោងម៉ាន់ហាត់ថាន់	Progetto Manhattan
ខេត្តយ៉ាម៉ាហ្គឹឈិ	Prefettura di Yamaguchi
ខេត្តខាន់ណាហ្គាវ៉ា	Prefettura di Kanagawa
បញ្ចកោណ	Pentagono
តំបន់ជឺហ្គុកឹ	Chūgoku
ខេត្តណាហ្គាណុ	Prefettura di Nagano
ខេត្តសៃតាម៉ា	Prefettura di Saitama
ខេត្តមីអិ	Prefettura di Mie
ណុត	Nodo (unità di misura)
តំបន់តុហុកកឹ	Regione di Tōhoku
ខេត្តហ្គឺនម៉ា	Prefettura di Gunma
ជ្រូកទឹក	Dugong dugon
ខ្សែទឹកមហាសមុទ្រ	Corrente oceanica
ខេត្តមីយ៉ាសាគី	Prefettura di Miyazaki
ខេត្តឃឹម៉ាម៉ុតុ	Prefettura di Kumamoto
មូលដ្ឋានូបនីយកម្មភាសា	Localizzazione (linguistica)
Mikoyan MiG-29	Mikoyan-Gurevich MiG-29
សប្ដាហ៏ពិសិដ្ឋ	Settimana santa
ឈូងសមុទ្រថៃ	Golfo del Siam
លី ក្វាន់យូ	Lee Kuan Yew
កម្មសិទ្ធិបញ្ញា	Proprietà intellettuale
អាណាខេត្តណារ៉ា	Prefettura di Nara
បុព្វបទនៅក្នុងប្រព័ន្ធខ្នាតអន្តរជាតិ	Prefissi del Sistema internazionale di unità di misura
យន្តហោះប៉ូឡូញកំទេចឆ្នាំ២០១០	Incidente del Tu-154 Siły Powietrzne del 2010
ជនភៀសខ្លួន	Rifugiato
ហង់រី កាវិនឌីស	Henry Cavendish
បុណ្យចូលឆ្នាំចិន	Capodanno cinese
ថេរវាទ	Buddhismo Theravada
តំបន់ខាន់តូ	Kantō
ខេត្តនីហ្គាតាក់	Prefettura di Niigata
ខេត្តយ៉ាម៉ាណាស៊ី	Prefettura di Yamanashi
ខេត្តស៊ីម៉ាណិ	Prefettura di Shimane
ខេត្តតុយ៉ាម៉ា	Prefettura di Toyama
ខេត្តអូកាយ៉ាម៉ា	Prefettura di Okayama
ISO 3166-2	ISO 3166-2
ខេត្តអយតាក់	Prefettura di Ōita
ខេត្តខូឈិ	Prefettura di Kōchi
អង្គការអន្តរជាតិនៃនយោបាយរបស់បារាំង	Organizzazione Internazionale della Francofonia
ភ្នំមេរ៉ាពី	Monte Merapi
ព្រះធម៌	Dharma
តំបន់ឈឺប៊ឹ	Regione di Chūbu
វ៉ាក់សាំង	Vaccino
រោគក្អកមាន់	Pertosse
គន្ថនិទ្ទេស	Bibliografia
កម្ពុជា នៅកីឡាអូឡាំពិករដូវក្ដៅ ២០០៨	Cambogia ai Giochi della XXIX Olimpiade
គីមឈី	Kimchi
ខេត្តកំពង់ចាម	Provincia di Kampong Cham
ខ្សែទឹកហ្គ្រីនលែនខាងកើត	Corrente della Groenlandia orientale
ខ្សែទឹកហាំបុល	Corrente di Humboldt
ដុនបូស្កូ	Giovanni Bosco
ធ្នូរង្វង់	Arco (geometria)
អប្សរា	Apsaras
ស្រុក	Distretto
រាជវង្សចោឡា	Chola
ខ្លារខិន ២ (រថក្រោះ)	Leopard 2
មហាអំណាច កណ្ដាល	Imperi centrali
អិចសា	Exa
ហិកតូ	Hecto
ដេកា	Deca
រ៉ូបឺតកាប៉ា	Robert Capa
មីល្លី	Milli (prefisso)
មីក្រូ	Micro (prefisso)
ពីកូ	Pico (prefisso)
ណាណូ	Nano (prefisso)
លីប៉ូល ស៊ីដាស៊ាងហ័រ	Léopold Sédar Senghor
វិគីភីឌាភាសាឥណ្ឌូនេស៊ី	Wikipedia in indonesiano
ទន្ដគោម	Agave (botanica)
ប្រវតិ្តBoney M	Boney M.
វីមេអូ	Vimeo
អំពើអនិត្យានុកូល	Violenza domestica
ហង់រី ការចេរ ប្រេស្សុង	Henri Cartier-Bresson
ត្រីកោណសម័ង្ស	Triangolo equilatero
ម៉ាក់ណូលា	Magnolia
ចូសេហ្វ ហិនរី	Joseph Henry
មន ស	Morus alba
ពិធីបញ្ជាប់ពាក្យ	Promessa di matrimonio
ត្រីកោណកែង	Triangolo rettangolo
សមុទ្រហ្វីលីពីន	Mare delle Filippine
ប្រព័ន្ធកូអ័រដោណេភូមិសាស្ត្រ	Geopolitica
Eurocopter Tiger	Eurocopter Tiger
តេត្រាអែត	Tetraedro
សឺន សាន	Son Sann
ម៉ោងផែនដី	Ora della Terra
នរោត្ដម សីហនុ	Norodom Sihanouk
ទន្លេរីយ៉ូហ្គ្រែនដេ	Rio Grande (fiume Stati Uniti d'America)
សំព័រ	Artocarpus
កម្មវិធីអភិវឌ្ឍន៍សហប្រជាជាតិ	Programma delle Nazioni Unite per lo sviluppo
ម៉ាស៊ីនថត លេកា	Leica
សេវាសាធារណៈ	Servizio pubblico
មេគុណជីនី	Coefficiente di Gini
នីត្រូគ្លីសេរីន	Nitroglicerina
វណ្ណយុត្តិ	Segno diacritico
ទង់ជាតិកម្ពុជា	Bandiera della Cambogia
ក្រុងអង្គរ	Angkor
ក្រពេញទីមុស	Timo (anatomia)
ទ្រឹស្តីបទកូស៊ីនុស	Teorema del coseno
ទក្សិណ ជិនវ័ត្រ	Thaksin Shinawatra
ប្រធាន	Soggetto (linguistica)
ហិនរី រ៉េម៉ុន	Henry Jarvis Raymond
អ៊ែង​ហ្គ្រី បឺដ	Angry Birds (serie)
អ៊ីពែបូល	Iperbole (geometria)
វិសមភាពស្វ័យគុណ	Disuguaglianza
XHTML	XHTML
គ្រោះទុរ្ភិក្ស	Carestia
អរិយសច្ច៤	Quattro nobili verità
ស្តាទិច	Statica
ខេត្តណាហ្គាសាគី	Prefettura di Nagasaki
វិគីភីឌាភាសាស្វីស	Wikipedia in svedese
ភ្លើងឆេះព្រៃ	Incendio boschivo
ទ្រឹស្តីបទស៊ីនុស	Teorema dei seni
ច្បាប់ហ៊ូក	Legge di Hooke
ក្រុមបាល់ទាត់ជម្រើសជាតិ ជប៉ុន	Nazionale di calcio del Giappone
រោគឈឺចាប់ក្នុងសន្លាក់ឆ្អឹង	Artrite
ប្លុកហ្គឺ (Blogger)	Blogger (piattaforma)
ធម្មនុញ្ញនៃអង្គការសហប្រជាជាតិ	Statuto delle Nazioni Unite
Boeing AH-64 Apache	Boeing AH-64 Apache
រោគហើមសួត	Bronchite
អេមីល្យូ ហ្គីណូ សេហ្គ្រែ	Emilio Segrè
Sukhoi Su-27	Sukhoi Su-27
ម៉ាស៊ីនត្រជាក់	Condizionatore d'aria
កាំ	Raggio (geometria)
អភិសិទ្ធិ វេជ្ជាជីវៈ	Abhisit Vejjajiva
HAL Tejas	HAL Tejas
លីមីត	Limite (matematica)
អ៊ីដ្រូស្តាទិច	Idrostatica
វិគីភីឌាភាសាជប៉ុន	Wikipedia in giapponese
គោលនយោបាយរូបិយវត្ថុ	Politica monetaria
យានដឹកជញ្ជូនសាធារណៈ	Trasporto pubblico
ការសំភាសន៏	Intervista
ពាណិជ្ជកម្មអន្តរជាតិ	Commercio internazionale
ចក្រភពអាណានិគមបារាំង	Impero coloniale francese
ពន្ធលើប្រាក់ចំណូល	Imposta sul reddito delle persone fisiche
HTML tag	Elemento HTML
រូបចំលាក់	Statua
នាឡិកាខ្សាច់	Clepsamia
ពុយមីស	Pomice
FM	Modulazione di frequenza
សង្គមស៊ីវិល	Società civile
សមុទ្របូហៃ	Mare di Bohai
ការិយាល័យ	Ufficio (locale)
ការបង្រៀនដែនដីបរិសុទ្ធ	E-learning
ម៉ែត្រក្នុងមួយវិនាទី	Metro al secondo
រូបមន្តហេរុង	Formula di Erone
ទន្សោង	Bos javanicus
វីតាមីន B	Vitamina B
គណៈកម្មាធិការជាតិអូឡាំពិក	Comitato olimpico nazionale
ប៉មតូក្យូ	Tokyo Tower
ទិវាទឹកអន្តរជាតិ	Giornata mondiale dell'acqua
រូបមន្តអយល័រ	Formula di Eulero
ស៊ីយ៉ាញួរ	Cianuro
អរិយដ្ឋង្គិកមគ្គ	Nobile Ottuplice Sentiero
សហភាពឥណ្ឌូចិន	Indocina francese
ចន្ទគតិ	Calendario lunare
សំទុះមុំ	Accelerazione angolare
អាស៊ីហ្គេមឆ្នាំ១៩៧០	VI Giochi asiatici
គោលនយោបាយសារពើពន្ធ	Politica fiscale
ឡាហ្គូន	Laguna
Mathew Brady	Mathew B. Brady
អប់សិន (ហិរញ្ញវត្ថុ)	Opzione (finanza)
អង្កត់ធ្នូ	Corda (geometria)
អាយុសង្ឃឹម	Speranza di vita
ជំនួយ:Using colours	Aiuto:Colori
ខុទ្ទកាល័យ	Consiglio di amministrazione
សីដក់	Sepak takraw
ធនាគារអភិវឌ្ឍន៍អាស៊ី	Asian Development Bank
បញ្ជីរដ្ឋមានអាវុធនុយក្លេអ៊ែរ	Stati con armi nucleari
ទីផ្សារអ៊ីធើណែត	Web marketing management
សៀវភៅ	Il libro della giungla
បារីអេឡិចត្រូនិច	Sigaretta elettronica
Eagles (ក្រុមភ្លេង)	Eagles
កំណើនសេដ្ឋកិច្ច	Crescita economica
យន្តសាស្រ្តរថយន្ត	Industria automobilistica
អាឌាម លេមបឺត	Adam Lambert
រូបមន្តដឺម័រ	Formula di de Moivre
អនុគមន៍ហ្គាំម៉ា	Funzione Gamma
ច្បាប់ប៉ាស្កាល់	Legge di Pascal
សញ្ញាជាតិបង់ក្លាដែស្ស	Stemma del Bangladesh
នាង​សីតា	Sita
សូរ (​ភាសាសាស្ត្រ​)	Lingua tonale
ខ្មែរក្រហម	Khmer Rossi
ម៉ូឌុល​យ៉ាំង	Modulo di elasticità
យុន ជីមិ-ហូ	Yun Chi-Ho
កែវម៉ាស៊ីនថត	Obiettivo fotografico
ទីភ្នាក់ងារសារព័ត៌មាន	Agenzia di stampa
វិគីភីឌាភាសាស្លូវ៉ាគី	Wikipedia in slovacco
ថេរហ្វារ៉ាដេយ	Costante di Faraday
ប្រវត្តិអ៊ីនធើណេត	Storia di Internet
សមភាពគួរកត់សំគាល់	Binomio
ខូប្រា	Copra
ទ្រឹស្តីបទមេនេឡូស	Teorema di Menelao
អត្ថបទ(ប្រើបា្រស់ភាសា)	Contesto (linguistica)
ជូគ័រលាង	Zhuge Liang
បំលែងឡាប្លាស	Trasformata di Laplace
សញ្ញាជាតិតួរគី	Emblema della Turchia
បឹងទន្លេសាប	Tonle Sap
Dassault Mirage 2000	Dassault Mirage 2000
ចំនួនអវិជ្ជមាន	Numero negativo
វិសុទ្ធិមគ្គ	Visuddhimagga
សញ្ញាជាតិវៀតណាម	Emblema del Vietnam
ខ្មែរ (ជនជាតិ)	Khmer (popolo)
សញ្ញាជាតិកូរ៉េខាងត្បូង	Stemma della Corea del Sud
សញ្ញាជាតិឡាវ	Emblema del Laos
សញ្ញាជាតិប៉ាគីស្ថាន	Stemma del Pakistan
Tigranes the Great	Tigrane II
អាណាចក្រខ្មែរ	Impero Khmer
ត្រីពណ៌	Tricolore
សញ្ញាជាតិប៊្រុយណេ	Stemma del Brunei
រង្វង់ត្រីកោណមាត្រ	Circonferenza unitaria
ចំរៀករង្វង់	Settore circolare
អនុគមន៍ដឺក្រេទី៣	Funzione cubica
អនុគមន៍អ៊ីពែបូលីក	Funzioni iperboliche
ឆាវ ឆាវ	Cáo Cāo
Sukhoi Su-30	Sukhoi Su-30
កម្មវិធីស្បៀងអាហារពិភពលោក	Programma alimentare mondiale
រៀល	Riel cambogiano
សមុទ្រស្ទើរបិទ	Mare marginale
ច្រកសិង្ហបុរី	Stretto di Singapore
វិគីភីឌាភាសារុស្ស៊ី	Wikipedia in russo
សញ្ញាជាតិអូម៉ង់	Stemma dell'Oman
ភាសាកម្មវិធី Lua	Lua
សញ្ញាជាតិប៊ូតាន	Stemma del Bhutan
ភ្លេងជាតិថៃ	Phleng Chat
ព្រះរតនត្រ័យ	Triratna
អាហារនៅប្រទេសម៉ិចស៊ិក	Cucina messicana
ច្រកឡាប៉េរូស	Stretto di La Pérouse
ផ្សារហិរញ្ញវត្ថុ	Mercato finanziario
ញ៉ែ	Flirt
ព្រះឆាយាល័ក្ខកម្ពុជា	Stemma della Cambogia
ខ្សែទឹកអាត្លង់ទិកខាងជើង	Corrente nord-atlantica
ប្រវត្តិសាស្ត្រវៀតណាម	Storia del Vietnam
ខ្សែទឹកខាណារី	Corrente delle Canarie
ទ្រឹស្តីបទឆិវ៉ា	Teorema di Ceva
LinkedIn	LinkedIn
ព្រះត្រៃបិដក	Canone pāli
បុណ្យវិសាខបូជា	Vesak
ទីក្រុងព្រែកឫស្សី	Cần Thơ
ជនជាតិចាម	Champa
រីស្ស៉ាត កាពុសស៊ីនស្គី	Ryszard Kapuściński
ប្រវត្តិសាស្ត្រភូមា	Storia della Birmania
ស៊ាន ឃីងស្តន	Sean Kingston
កងទ័ពជើងទឹកបារាំង	Marine nationale
ចំប៉ី	Plumeria
អនុគមន៍បេសែ្សល	Armoniche cilindriche
លោក អាប់ឌូ ឌីអោហ្វ	Abdou Diouf
វិធីហ្វៃណៃថ៍អ៊េលម៉ិន	Metodo degli elementi finiti
ច្បាប់អគ្គីសនីវិភាគរបស់ហ្វារ៉ាដេយ	Leggi di Faraday sull'elettrolisi
ខេត្តព្រះសីហនុ	Sihanoukville
មានប្រ	Anggun
ដុនបូស្កូសាឡេស៊ាន្ត	Società Salesiana di San Giovanni Bosco
អង្គរធំ	Angkor Thom
Kara	Kara
១៤១	141 (numero)
ប្រទេសនៅអឺរ៉ុប	Stati dell'Europa
វិទ្យុសម្លេងសហរដ្ឋអាមេរិក	Voice of America
ជេឃ្វីរី	JQuery
ទិវាពិភពលោកគ្មានថ្នាំជក់	Giornata mondiale senza tabacco
គម្ពីរបញ្ចតន្ត្រ	Pañcatantra
មេដ្យាន	Mediana (geometria)
ផ្លាយ អាស់	Cenere volante
T-80	T-80
សញ្ញាជាតិកាតារ	Stemma del Qatar
សញ្ញាយ៉ាកូប៊ី	Simbolo di Jacobi
មីហ៊្គោ	MeeGo
វិភាគចិត្តវិទ្យា	Psicologia analitica
លីវ ប៉ី	Liu Bei
កិច្ចព្រមព្រៀងពាណិជ្ជកម្ម	Accordo commerciale
សង្គ្រាមគ្រីមៀ	Guerra di Crimea
ក្ងោកបៃតង	Pavo muticus
Pinterest	Pinterest
អាស៊ីហ្គេមឆ្នាំ១៩៦២	IV Giochi asiatici
ភ្នំសេមេរូ	Semeru
កោះសមុយ	Ko Samui
ថវិការដ្ឋាភិបាល	Bilancio dello Stato
អាំងតេក្រាលដោយផ្នែក	Integrazione per parti
ផ្សោតក្បាលត្រឡោក	Orcaella brevirostris
Near Field Communication	Near Field Communication
ហិរញ្ញវត្ថុសាធារណៈ	Finanza pubblica
សាលាសំណាក់	Padiglione (architettura)
ជយវម៌្មទី១	Jayavarman I
ប្រាសាទក្រោលគោ	Krol Ko
រូបមន្តអយល័រ-ម៉ាក្លូរីន	Formula di Eulero-Maclaurin
១៤៨	148 (numero)
AIDC F-CK-1 Ching-kuo	AIDC F-CK-1 Ching-kuo
OSM	OSM
ខេត្តសាឡៈវ៉ាន់	Provincia di Salavan
WikiHow	Wikihow
ប្រាសាទមេបុណ្យខាងកើត	Mebon orientale
ទិន្នន័យបើកចំហ	Dati aperti
ទិន ហ្វី	Stephen Chow
ហាំង ង៉ោ	Haing S. Ngor
ព្រះបាទសូរ្យវរ្ម័នទី២	Suryavarman II
ហិនរី វីលសុន	Henry Wilson
ហុងដា សូអ៊ិជិរ៉ូ	Sōichirō Honda
ស៊ុន ឈាន	Sun Quan
ឆាវ ភី	Cao Pi
ម៉ាស៊ីនថតវីឌីអូ	Telecamera
ពិម្ពិសារ	Bimbisāra
ដូមីនិក សាវីយ៉ូ	Domenico Savio
ក្រុមបាល់ទាត់ជម្រើសជាតិកម្ពុជា	Nazionale di calcio della Cambogia
ព្រះសារីបុត្រ	Śāriputra
ទ្រឹស្តីបទគ្រីន	Teorema di Green
ប្រាសាទអូសាកា	Castello di Osaka
ការប្រើប្រាស់ភាសា	Linguistica applicata
គោព្រៃ	Bos sauveli
VCD	Video CD
ថ្ងៃបាស់ស្ទីល	Festa nazionale francese
កម្ពុជាប្រជាធិបតេយ្យ	Kampuchea Democratica
សាលាក្ដីខ្មែរក្រហម	Tribunale speciale della Cambogia
ខេត្តផុងសាលី	Provincia di Phongsali
ខេត្តបកែវ	Provincia di Bokeo
ខេត្តចំប៉ាសក្តិ	Provincia di Champasak
កិលេស	Passione (psicologia)
ព្រះបាទជ័យវរ្ម័នទី៧	Jayavarman VII
កស្សបៈ	Mahākāśyapa
កាំង ហ្កិច អ៊ាវ	Kang Kek Iew
ស៊ឺ ម៉ាអ៉ី	Sima Yi
ចំនុចហ្គែរហ្គោន	Incerchio
ប្រវត្តិសាស្រ្តនៃរូបថត	Storia della fotografia
ឋានន្តរសក្ដិរាជវង្សនិងអភិជន	Ranghi reali e nobiliari
សឺង ង៉ុកថាញ់	Son Ngoc Thanh
ក្រុមហ៊ុនអាកាសចរណ៍ជាតិ កម្ពុជាអង្គរអ៊ែរ	Cambodia Angkor Air
ទ្រឹស្តីបទមេអំបៅ	Teorema della farfalla
កន្ថឹក	Tupaia belangeri
ហេង សំរិន	Heng Samrin
ខៀវ សំផន	Khieu Samphan
ព្យែរ វ៉ារីញ៉ុង	Pierre Varignon
អៀង សារី	Ieng Sary
ជយវម៌្មទី៣	Jayavarman II
អជាតសត្តុ	Ajātashatru
បន្ទាត់អយល័រ	Retta di Eulero
ប្រវត្តិសាស្ត្រថៃ	Storia della Thailandia
បុណ្យសែនព្រះខែ	Festa di metà autunno
គុណកិរិយា	Avverbio
ឌីណាមិក HTML	DHTML
នូហាក់ ភូមសៈវ៉ាន់	Nouhak Phoumsavanh
កុំផ្លិចឆ្លាស់	Complesso coniugato
ប្រាសាទអកយំ	Ak Yum
សាសនានៅប្រទេសកម្ពុជា	Religioni in Cambogia
គោលនយោបាយកសិកម្ម	Politica agraria
ហង់រី មូហូ	Henri Mouhot
ប្រវត្តិសាស្ត្រលាវ	Storia del Laos
តារាងអាំងតេក្រាល	Tavola degli integrali più comuni
បន្ទាត់សេកង់	Secante (geometria)
ពហុកោណស្មើ	Poligono equilatero
ប្រាសាទតាកែវ	Ta Keo
សម្ដេចប៉ាបហ្វ្រង់សូ័រ	Papa Francesco
ទ្រឹស្តីបទតូលេមី	Teorema di Tolomeo
Regional Internet registry	Regional Internet Registry
គុណវិបត្តិនៃការជក់បារី	Effetti del tabagismo sulla salute
ខ្វែងជ័យបុរី	Provincia di Xaignabouli
ខ្វែងជើងខ្វែង	Provincia di Xiangkhoang
ខេត្តឧត្តមជ័យ	Provincia di Oudomxay
ខេត្តកោះកុង	Provincia di Koh Kong
ខេត្តកណ្ដាល	Provincia di Kandal
ម៉ារី ដូមីនិក ម៉ាសារីលូ	Maria Domenica Mazzarello
ព្រះនាងយសោធរា	Yashodharā
អនុគមន៍បែតា	Funzione beta di Eulero
លិង្គ	Linga
កូម៌ៈ	Kurma
អាស៊ីហ្គេមឆ្នាំ១៩៧៤	VII Giochi asiatici
អាកាសយានដ្ឋានអន្តរជាតិតានសូនណាត្ត	Aeroporto Internazionale Tan Son Nhat
KAI T-50 Golden Eagle	KAI T-50 Golden Eagle
វីគីប្រជុំ	Wikimania
អាស៊ីហ្គេម	Giochi asiatici
ទង់ជាតិសិង្ហបុរី	Bandiera di Singapore
បង្អួចឆ្នាំ 2000	Windows 2000
តារាងអាំងតេក្រាលនៃអនុគមន៍សនិទាន	Tavola degli integrali indefiniti di funzioni razionali
តារាងអាំងតេក្រាលនៃអនុគមន៍អ៊ីពែបូលីក	Tavola degli integrali indefiniti di funzioni iperboliche
សមីការដឺក្រេទី១	Equazione lineare
តារាងអាំងតេក្រាលនៃអនុគមន៍ច្រាស់អ៊ីពែបូលីក	Tavola degli integrali indefiniti di funzioni d'area
សញ្ញាជាតិអាហ្វហ្គានីស្ថាន	Emblema dell'Afghanistan
E-commerce	Commercio elettronico
Sukhoi Superjet 100	Sukhoi Superjet 100
អ្នក​មាន​ជាង​គេ​លើ​ពិភពលោក	Uomini più ricchi del mondo secondo Forbes
គណកម្មាធិការអូឡាំពិកកូរ៉េ	Comitato Olimpico Coreano
អាស៊ីហ្គេមឆ្នាំ២០០២	XIV Giochi asiatici
ឆកសមុទ្របូហៃ	Baia di Bohai
T-ARA	T-ara
អាស៊ីហ្គេមឆ្នាំ១៩៨៦	X Giochi asiatici
អាណាស្រុកម៉ូបាល (អាល់ឡាបាម៉ា)	Contea di Mobile
ម្កាក់	Spondias dulcis
បារខែម	BarCamp
ព្រះបាទសូរ្យវរ្ម័នទី១	Suryavarman I
ខេត្តកំពង់ធំ	Provincia di Kampong Thom
ខេត្តព្រះវិហារ	Provincia di Preah Vihear
ខេត្ត ហួ ផាន់	Provincia di Houaphan
ខ្វែងអាចម៍ក្រពើ	Provincia di Attapeu
ខេត្តខាំមួន	Provincia di Khammouan
ខេត្តប៉ៃលិន	Pailin
បារីសង់	Baricentro (geometria)
វិសមភាពប៊ូល	Disuguaglianze di Boole e di Bonferroni
ស៊ីសុវត្ថិ មុនីវង្ស	Sisowath Monivong
រូបមន្តប្រេឆ្នៃដឺ	Formula di Bretschneider
ក្រុមបាល់ទាត់ជម្រើសជាតិ កូរ៉េខាងត្បូង	Nazionale di calcio della Corea del Sud
សុញ្ញតា	Śūnyatā
គោលនយោបាយសាធារណៈ	Politica pubblica
Xian MA60	Xian MA60
ស្រុកអន្លង់វែង	Anlong Veng
កស្ថានីយភ្នំបូកគោ	Stazione climatica di Bokor
ម៉ាសែលលីន ចាមប៉ាញេត	Marcellin Champagnat
ព្រះបាទយសោវរ្ម័នទី១	Yasovarman I
អេដូអារដូ អាម៉ាល់ឌី	Edoardo Amaldi
Chengdu J-20	Chengdu J-20
វេយ្យាករណ៍អង់គ្លេស	Grammatica inglese
ព្រះបាទឥន្រ្ទវរ្ម័នទី១	Indravarman I
ស៊ីឡាត	Silat
ទ្រឹស្តីបទវ្យែត	Formule di Viète
ប្រាសាទភ្នំបាខែង	Phnom Bakheng
តារាងអាំងតេក្រាលនៃអនុគមន៍អិចស្ប៉ូណង់ស្យែល	Tavola degli integrali indefiniti di funzioni esponenziali
តារាងអាំងតេក្រាលនៃអនុគមន៍អសនិទាន	Tavola degli integrali indefiniti di funzioni irrazionali
តារាងអាំងតេក្រាលនៃអនុគមន៍លោការីត	Tavola degli integrali indefiniti di funzioni logaritmiche
អាំងតេក្រាលហ្វ្រេនែល	Integrale di Fresnel
គោលនយោបាយសេដ្ឋកិច្ច	Politica economica
ប្រាសាទភិមានអាកាស	Phimeanakas
Baskin​-Robbins បាន	Baskin-Robbins
ទិវាសេរីភាពសារព័ត៌មានពិភពលោក	Giornata mondiale della libertà di stampa
ប្រាសាទតាព្រហ្ម	Ta Prohm
អាជ្ញាធរអន្តរកាលសហប្រជាជាតិនៅកម្ពុជា	UNTAC
ប្រាសាទធម្មនន្ទ	Thommanon
អាំងតេក្រាលផ្ទៃ	Integrale di superficie
ប្រាសាទមេបុណ្យខាងលិច	Mebon occidentale
ប្រាសាទបន្ទាយក្តី	Banteay Kdei
ក្រុងសំរោង	Samraong
ប្រាសាទបន្ទាយសំរែ	Banteay Samré
ស្រះស្រង់	Srah Srang
ខេត្តតាកែវ	Provincia di Takéo
លានស្តេចគំលង់	Terrazza del Re lebbroso
ខេត្តហ៊ីរ៉ូស៊ីម៉ា	Prefettura di Hiroshima
ព្រះសហគមន៏កាតូលិកភូមិភាគភ្នំពេញ	Vicariato apostolico di Phnom-Penh
បន្ទប់រៀន	Aula
ជំរំជនភៀសខ្លួន	Campo per rifugiati
ហ្គូតហ្គោល	Google Sites
ខេត្តឧត្ដរមានជ័យ	Provincia di Oddar Meancheay
អុក	Makruk
បទនគររាជ	Nokoreach
នគររាជសីមា	Nakhon Ratchasima
ចំនួនអាកស៊ីម៉ែដ	Numero di Archimede
សង្គ្រាមកម្ពុជា-វៀតណាម	Guerra cambogiana-vietnamita
តំលៃលើការចាប់អារម្មណ៍	Cost per mille
កីឡាចុងបូព៌ាឆ្នាំ១៩២៥	VII Giochi dell'Estremo Oriente
បញ្ជីរាយនាម ជ័យលាភីរង្វាន់ណូបែលសន្តិភាព	Vincitori del premio Nobel per la pace
១៥០	150 (numero)
ISO 3166-2:KH	ISO 3166-2:KH
ទ្រឹស្តីបទពីក	Teorema di Pick
ខេត្តសៀមរាប	Provincia di Siem Reap
ខេត្តមណ្ឌលគិរី	Provincia di Mondulkiri
ខេត្តកំពង់ស្ពឺ	Provincia di Kampong Speu
ប្រាសាទបាយ័ន	Bayon (Angkor)
អុនសេន	Onsen
ឧត្តមស្នងការអង្គការសហប្រជាជាតិទទួលបន្ទុកសិទ្ធិមនុស្ស	Alto commissariato delle Nazioni Unite per i diritti umani
សម រង្ស៊ី	Sam Rainsy
ជាតក	Jātaka
ក្រុងហាកុណិ (ខេត្តកាណាហ្គាវ៉ា)	Hakone
អនុគមន៍ត្រីកោណមាត្រច្រាស់	Funzione trigonometrica inversa
ប្រវត្តិសាស្ត្រខ្មែរ	Storia della Cambogia
ម៉ាជូ ពីជូ	Machu Picchu
ខ្សែទឹកប្រេស៊ីល	Corrente del Brasile
ក្រុមអសនិក (អាកាសចរណ៍)	Squadriglia
Pilatus PC-7	Pilatus PC-7
ត្រកៀតប៉ោង	Eichhornia crassipes
ជ្រោយណុតុ	Penisola di Noto
ចតុកោណចារឹកក្នុងរង្វង់	Quadrilatero ciclico
១៣៨	138 (numero)
គីឡូម៉ែត្រការ៉េ	Chilometro quadrato
ចេននី រីវឺរ៉ា	Jenni Rivera
ពហុកោណនិយ័ត	Poligono regolare
១៤៤	144 (numero)
១៤០	140 (numero)
១៤៣	143 (numero)
១៤៧	147 (numero)
១៤៦	146 (numero)
១៤៩	149 (numero)
១៤២	142 (numero)
១៣៩	139 (numero)
១៤៥	145 (numero)
ប្រទេសមួយ ប្រព័ន្ធពីរ	Una Cina due sistemi
បណ្តាញផ្លូវហាយវេអាស៊ី	Autostrade asiatiche
អាស៊ីហ្គេមឆ្នាំ១៩៥៤	II Giochi asiatici
អាស៊ីហ្គេមឆ្នាំ១៩៥៨	III Giochi asiatici
អាស៊ីហ្គេមឆ្នាំ១៩៦៦	V Giochi asiatici
អាស៊ីហ្គេមឆ្នាំ១៩៧៨	VIII Giochi asiatici
អាស៊ីហ្គេមឆ្នាំ១៩៨២	IX Giochi asiatici
អាស៊ីហ្គេមឆ្នាំ១៩៩០	XI Giochi asiatici
អាស៊ីហ្គេមឆ្នាំ១៩៩៤	XII Giochi asiatici
អាស៊ីហ្គេមឆ្នាំ១៩៩៨	XIII Giochi asiatici
Hongdu JL-8	Hongdu JL-8
ឃុំប៉ោយប៉ែត	Paoy Paet
ច្រកចូហរ	Stretto di Johor
នគរលូ	Lu (stato)
Yeghishe Charents	Yeghishe Charents
Siedlnica	Siedlnica
Hongdu L-15	Hongdu L-15 Lie Ying
CAC/PAC JF-17 Thunder	Joint Fighter JF-17 Thunder
ខេត្តរតនគិរី	Provincia di Ratanakiri
បញ្ចក្ខន្ធ	Skandha
Gloomy Sunday	Gloomy Sunday
ខេត្តហ្លួងព្រះបាង	Provincia di Luang Prabang
ខេត្តកំពត	Provincia di Kampot
សង្គ្រាមឥណ្ឌូចិនលើកទី១	Guerra d'Indocina
ខេត្តស្វាយរៀង	Provincia di Svay Rieng
សង្គាយនា	Concili buddhisti
ISO 9362	ISO 9362
ខ្លែងប្រម៉ង់	Microhierax caerulescens
ទ្រឹស្ដីបទការ៉េទាំង៤របស់ឡាហ្គ្រង់	Teorema dei quattro quadrati
សុត្តន្តបិដក	Sutta Piṭaka
ខេត្តអូគីណាវ៉ា	Prefettura di Okinawa
លានជល់ដំរី	Terrazza degli elefanti
មឹង អ៊ី	Meng Yi
គណបក្សប្រជាជនកម្ពុជា	Partito Popolare Cambogiano
ទន្លេបាទី	Tonle Bati
អាស៊ីខាងត្បូង	Asia meridionale
កំណាត់រង្វង់	Segmento circolare
ខេត្តក្រចេះ	Provincia di Kratié
ប្រាសាទបាគង	Bakong
ប្រាសាទបក្សីចាំក្រុង	Baksei Chamkrong
ប្រាសាទបន្ទាយស្រី	Banteay Srei
ប្រាសាទបាពួន	Baphuon
សមីការឌីផេរ៉ង់ស្យែលប៊ែរនូយី	Equazione differenziale di Bernoulli
ឃុំបន្ទាយឆ្មារ	Banteay Chhmar
ខេត្តបាត់ដំបង	Provincia di Battambang
តំបន់ត្រីកោណមាស	Triangolo d'oro
ប្រាសាទបឹងមាលា	Beng Mealea
សង្គ្រាមផ្ទៃក្នុងកម្ពុជា	Guerra civile cambogiana
ESET	Eset
អាស៊ីហ្គេមរដូវរងារ	Giochi asiatici invernali
ក្រុងយ៉ាណៃ	Yanai
កុសិនារា	Kushinagar
KM	Chilometro
BRIC	BRIC
បញ្ជីព្រះមហាក្សត្រកម្ពុជា	Sovrani della Cambogia
ជម្រើសអ្នកប្រើប្រាស់	Teoria del consumatore
ខេត្តពោធិ៍សាត់	Provincia di Pursat
វិស័យអប់រំនៅប្រទេសជប៉ុន	Istruzione in Giappone
ខេត្តស្ទឹងត្រែង	Provincia di Stung Treng
ប្រព័ន្ធគោល	Base (aritmetica)
ក្រុមប្រឹក្សាអូឡាំពិកអាស៊ី	Consiglio Olimpico d'Asia
McDonnell Douglas F-15E Strike Eagle	McDonnell Douglas F-15E Strike Eagle
២៤២	242 (numero)
តារាងអាំងតេក្រាលនៃអនុគមន៍ត្រីកោណមាត្រ	Tavola degli integrali indefiniti di funzioni trigonometriche
ច្រកកាលីម៉ាតា	Stretto di Karimata
បញ្ជី ប្រទេស មានចំនួនអ្នកអានសៀវភៅ	Stati per tasso di alfabetizzazione
សារមន្ទីរទួលស្លែង	Tuol Sleng Genocide Museum
ខេត្តកែប	Kep (Cambogia)
បញ្ជីអ្នកទទួលបានជ័យលាភីណូបែលខាងរូបវិទ្យា	Vincitori del premio Nobel per la fisica
VietJet Air	VietJet Air
ក្រុងសិរីសោភ័ណ	Sisophon
ក្រុងកំពង់ចាម	Kampong Cham
សាកលវិទ្យាល័យ ចុឡាលុងករណ៍	Università Chulalongkorn
Gallery of dependent territory flags	Bandiere di territori dipendenti
អនុគមន៍ស៊ីនុសកាឌីណាល់	Funzione sinc
ខេត្តព្រៃវែង	Provincia di Prey Veng
អនុគមន៍ពហុហ្គាំម៉ា	Funzione poligamma
ទ្រឹស្តីបទកូស៊ី-អាដាម៉ា	Teorema di Cauchy-Hadamard
គណៈកម្មាធិការជាតិអូឡាំពិកកម្ពុជា	Federazione Sportiva e Comitato Olimpico della Cambogia
កប្ប	Kalpa
សាធារណរដ្ឋប្រជាមានិតកម្ពុជា	Repubblica Popolare di Kampuchea
នគរវ្នំ	Regno del Funan
ក្រុងកំពត	Kampot
ខេត្តកំពង់ឆ្នាំង	Provincia di Kampong Chhnang
ស៊ីហ្គេម	Giochi del Sud Est Asiatico
ទ្រឹស្តីបទមេដ្យាន	Teorema della mediana
ព្រះនាងមាយា	Regina Maya
ពោធិបក្ខិយធម៌	Bodhipakkhika Dhamma
បាល់ទាត់កញ្ចុំផ្កាយ	Galactik Football
ការ​បញ្ចាំង​ស្លាយ	Diaporama
វីគីភីឌាភាសាខ្មែរ	Composti organici volatili
ប្រទេសនៅអាមេរិកខាងត្បូង	Stati del Sud America
ចំប៉ីសៀម	Adenium
ជំនួយ:មាតិកា	Aiuto:Aiuto
ច្បាប់ប្រលេឡូក្រាម	Legge del parallelogramma
ចំនុចប៊្រូការ	Punti di Brocard
ទ្រឹស្តីបទកន្លះបន្ទាត់ពុះមុំ	Teorema della bisettrice
AgustaWestland Apache	Westland WAH-64 Apache
មីក្រូម៉ែត្រការ៉េ	Ordini di grandezza (superficie)
ព្រៃវែង	Prey Veng
ជួរភ្នំដងរែក	Monti Dângrêk
ប្រាសាទព្រះខ័ន	Preah Khan
រូបមន្តញូតុន-កូត្ស	Formule di Newton-Cotes
កបិលវត្ថុ	Kapilbastu
ភ្នំគូលេន	Phnom Kulen
ស្វាកន្ទុយស	Pygathrix nigripes
ប្រាសាទភ្នំក្រោម	Phnom Krom
Nanchang Q-5	Nanchang Q-5
ពិធីបុណ្យមាឃបូជា	Magha Puja
ប្រដាល់សេរី	Pradal Serey
សុន សេន	Son Sen
គណកម្មាធិការអូឡាំពិកជប៉ុន	Comitato Olimpico Giapponese
ចំនួនតេត្រាអែក	Numero tetraedrico
ក្រុងកំពង់ធំ	Kampong Thom
អង់រីកូ ពែរស៊ីកូ	Enrico Persico
ភ្នំដា	Angkor Borei
អាំងតេក្រាលអយល័រ	Integrale di Eulero
ចំណុចរំពុះ	Punto di ebollizione
ក្រុងប៉ោយប៉ែត	Poipet
តារាងលីមីត	Limite notevole
វិសមភាពភីដូ	Disuguaglianza di Pedoe
ក្រុងកំពង់ឆ្នាំង	Kampong Chhnang
តារាងអាំងតេក្រាលនៃអនុគមន៍ច្រាស់ត្រីកោណមាត្រ	Tavola degli integrali indefiniti di funzioni d'arco
គណកម្មាធិការអូឡាំពិកជាតិសិង្ហបុរី	Consiglio Olimpico Nazionale di Singapore
ត្រៃលក្ខណ៍	Tre Segni dell'Esistenza
អាកាសយានដ្ឋានអន្តរជាតិភ្នំពេញ	Aeroporto Internazionale di Phnom Penh
វិសមភាពអូណូ	Disuguaglianza di Ono
អាកាសយានដ្ឋានអន្តរជាតិសៀមរាបអង្គរ	Aeroporto Internazionale di Siem Reap-Angkor
បច្ចេកវិទ្យាសារពត៌មាន	Giornalismo on-line
ក្មេងទំនើង	Delinquenza minorile
ចេនឡា	Regno di Chenla
ស្ដេចចក្រពត្តិ	Cakravartin
តថាគត	Tathāgata
ប្រាសាទនាគព័ន្ធ	Neak Pean
ជា ស៊ីម	Chea Sim
នគរឆឹន	Chen (stato)
អាំងតេក្រាលប្តូរអថេរ	Integrazione per sostituzione
កម្មវីធីសូនីវីហ្គាស	Sony Vegas
ស៊ីហ្គេមលើកទី២៥	Giochi del Sud Est Asiatico 2009
ការប្រកួតកីឡាជើងឯកចុងបូព៌ា	Giochi dell'Estremo Oriente
កងទ័ពអេហ្ស៊ីប	Forze armate egiziane
ប្រាសាទប្រែរូប	Pre Rup
ប្រាសាទក្រវាន់	Prasat Kravan
តារាងដេរីវេ	Regole di derivazione
មេកានិច​សូលីដ	Meccanica dei solidi
ការប្រកួតកីឡា កម្ពុជា	C-League
ប្រាសាទព្រះគោ	Preah Ko
ប្រាសាទលលៃ	Lolei
ក្បាលស្ពាន	Kbal Spean
ប្រាសាទតាសោម	Ta Som
ស្ពានថ្ម	Spean Thma
អនុគមន៍ស្ករ៉ឺ	Funzioni di Scorer
CAIC Z-10	CAIC WZ-10
អាំងតេក្រាលត្រីកោណមាត្រ	Funzioni integrali trigonometriche
សមីការឌីផេរ៉ងស្យែលក្លែរ៉ូ	Equazione di Clairault
សាសនា សកល	Simbolismo religioso
ខ្សែទឹកណរវេយ	Corrente norvegese
ទង់ព្រះពុទ្ធសាសនា	Bandiera buddhista
វិសមភាពញូតុន	Disuguaglianza di Newton
មករ	Makara (mitologia indiana)
ISO 3166-1 alpha-2	ISO 3166-1 alpha-2
តំបន់អឌ្ឍច័ន្ទមាស	Mezzaluna d'oro
បណ្ឌិត្យ​សភា​នីតិ​អន្តរជាតិ​នៃ​ទីក្រុង​ឡាអេ	Accademia del diritto internazionale
សម្រែកនៃដុលោរ៉េស៏	Grito de Dolores
ប្រពលវប្បកម្ម	Coltura intensiva
សមភាពការ៉េទាំង៤របស់អឺលែរ	Identità dei quattro quadrati di Eulero
រូបមន្តប្រាម៉ាហ្គឹបតា	Formula di Brahmagupta
ផ្នែកពិត	Parte reale
សមីការហ៊ីល	Equazione di Hill (matematica)
កីឡាចុងបូព៌ាឆ្នាំ១៩៣៨	XI Giochi dell'Estremo Oriente
សមភាពការ៉េទាំង៨របស់ដេហ្គេន	Identità degli otto quadrati di Degen
វិសមភាព វេតស្សឹនបុក	Disuguaglianza di Weitzenböck
រូប	Rūpa
Kawasaki OH-1	Kawasaki OH-1
បុណ្យ តារា	Tanabata
ក្រុមមិត្តភក្តិ (Peer group)	Gruppo dei pari
ក្រុងតាកែវ	Takéo
សមីការកូស៊ី-អយល័រ	Equazione di Eulero
OSGeo	OSGeo
វិគីភីឌា:ស្ថានទូតខ្មែរ	Wikipedia:Ambasciata
Bottleneck	Bottleneck
រាជវង្សហុងបាង	Dinastia Hồng Bàng
កីឡាចុងបូព៌ាឆ្នាំ១៩១៧	III Giochi dell'Estremo Oriente
ទីឃនិកាយ	Dīgha Nikāya
ហ្វ្រង់កូ រ៉ាសិតទី	Franco Rasetti
បញ្ជីរាយនាម កោះនៅកម្ពុជា	Isole della Cambogia
កូស៊ីនុស	Coseno
តូនី វ៉ាការ៉ូ	Tony Vaccaro
អាន ដ្យឿង វឿង	An Dương Vương
ខ្សែទឹកកោះបាហ្វហ្វីន	Corrente dell'isola di Baffin
វិសមភាពស្យ៉ឺរ	Disuguaglianza di Schur
ឈូងសមុទ្រ	Golfo
អនុគមន៍ហ្គុឌែរម៉ាន់	Funzione gudermanniana
វិធីសាស្រ្តហ្រ្វូបេនៀស	Metodo di Frobenius
ផ្នែកនិម្មិត	Parte immaginaria
ចន វ៉នណុក	John Warnock
ឃុនបរម	Khun Borom
មួយម៉ូនីកា	Agnes Monica
Candies	Candies (gruppo musicale giapponese)
ខ្មែរក្រោម	Khmer krom
សមាគមអូឡាំពិកឥណ្ឌា	Comitato Olimpico Indiano
កីឡាចុងបូព៌ាឆ្នាំ១៩១៥	II Giochi dell'Estremo Oriente
កីឡាចុងបូព៌ាឆ្នាំ១៩១៣	I Campionato dei Giochi dell'Estremo Oriente
ប្រាសាទព្រះប៉ាលីឡៃ	Preah Palilay
ក្រុងបាវិត	Bavet
ស្រុកសំឡូត	Samlout
ស្រុកកំពង់ត្រឡាច	Distretto di Kampong Tralach
ESET NOD32 Antivirus	NOD32
វិគីភីឌា:Glossary	Aiuto:Glossario
ចំណាត់ថ្នាក់ក្រុម:ប្រទេសជប៉ុន	Categoria:Giappone
ចំណាត់ថ្នាក់ក្រុម:ម៉ិកសិច	Categoria:Messico
ចេមនិងផ្លែប៉ែសយក្ស	James e la pesca gigante (romanzo)
ស្ងោរជ្រក់សាច់មាន់	Brodo di pollo
ចំណាត់ថ្នាក់ក្រុម:ឥណ្ឌូនេស៊ី	Categoria:Indonesia
ចំណាត់ថ្នាក់ក្រុម:សិង្ហបុរី	Categoria:Singapore
ចំណាត់ថ្នាក់ក្រុម:រូបវិទ្យា	Categoria:Fisica
ចំណាត់ថ្នាក់ក្រុម:វិទ្យាសាស្រ្តធម្មជាតិ	Categoria:Scienze naturali
ចំណាត់ថ្នាក់ក្រុម:ជីវវិទ្យា	Categoria:Biologia
ចំណាត់ថ្នាក់ក្រុម:សាសនា	Categoria:Religione
ចំណាត់ថ្នាក់ក្រុម:កីឡា	Categoria:Sport
ចំណាត់ថ្នាក់ក្រុម:វិទ្យាសាស្ត្រ	Categoria:Scienza
ប្រជាមតិទាក់ទងនឹងឯករាជភាពរបស់ស្កុតឡែនឆ្នំា២០១៤	Referendum sull'indipendenza della Scozia del 2014
សាសនាក្នុងប្រទេសចិន	Religioni in Cina
ខួច​គូថ	Losanga di Michaelis
ចំនួនហ្គាលីលេ	Numero di Galilei
ត្រីគល់រាំង	Catlocarpio siamensis
ប្រវត្តិសាស្រ្តរបស់ទូរទស្សន៍	Storia della televisione
ប្រវត្តិវិទ្យុ	Cronologia della radio
ប្រវត្តិសាស្រ្តអ្នកកាសែត	Storia del giornalismo
ប្រវត្តិច្បាប់រក្សាសិទ្ធ	Storia del diritto d'autore
Honda HA-420 HondaJet	Honda HA-420 HondaJet
នើនដូ	Steinberg Nuendo
Guizhou JL-9	Guizhou JL-9
ប្រាសាទភ្នំជីសូរ	Phnom Chisor
ស្ដង់ដា	Standard
ចំនុចកណ្ដាល	Punto medio
ចាន់ ស៊ី	Chan Sy
ប៉ាន់ រិទ្ធី	Rithy Panh
ទំព័រគំរូ:Dts	Template:Dts
ទីក្រុងរ៉ូមបុរាណ	Civiltà romana
កន្ថឹកក្បាលឆ្នូត	Dendrogale murina
ប្រាសាទកោះកេរ	Koh Ker
នរោត្ដម សុរាម្រិត	Norodom Suramarit
អាស៊ីហ្គេមអ៊ីនដរ	Giochi asiatici indoor
អាំងតេក្រាលមាឌ	Integrale di volume
ក្លឹបបាល់ទាត់ ភ្នំពេញក្រោន	Phnom Penh Crown
សញ្ញាណលោការីត	Identità sui logaritmi
ប្រាសាទសំបូរព្រៃគុក	Sambor Prei Kuk
អាគីតា	Akita (disambigua)
ចំណាយរដ្ឋាភិបាល	Spesa pubblica
សារមន្ទីរជាតិ	Museo nazionale di Cambogia
អ្នកសារពត័មាន	Giornalista
រង្វង់ប៊្រូការ	Cerchio di Brocard
ប៉ែន សុវណ្ណ	Pen Sovan
ក្រុងតាខ្មៅ	Ta Khmau
ចំណាត់ថ្នាក់ក្រុម:អូឡាំពិក	Categoria:Giochi olimpici
ចំណាត់ថ្នាក់ក្រុម:ព្រះពុទ្ធសាសនា	Categoria:Buddhismo
ប្រទេសនៅអាមេរិកខាងជើង	Stati del Nord America
បញ្ជីឈ្មោះអនុគមន៍គណិតវិទ្យា	Lista di funzioni
ស្ពានប្រាប់ទិស	Spean Praptos
ណូរី	Bamboo Train
ជំងឺរលាកបំពង់ក	Faringite
អង្គការសង្គមអភិរក្សសត្វព្រៃ	Wildlife Conservation Society
ស្រុកមេមត់	Memot
ឧទ្យានជាតិវីរៈជ័យ	Parco nazionale di Virachey
ចំនួនអូតូម៉ហ្វីស	Numero automorfo
អូរកែវ	Óc Eo
ពហុធាប៊ែរនូយី	Polinomio di Bernoulli
ប្រាសាទព្រះពិធូរ	Preah Pithu
ការផ្សាយពាណិជ្ជកម្ម	Display advertising
អ្នកលឿង	Neak Luong
ឃុំរលួស (ស្រុកស្វាយចេក)	Roluos
ខេត្តបលិខាំសៃ	Provincia di Bolikhamxai
ស្ពានព្រះមុនីវង្ស	Ponte Monivong
សោតទស្សន៏	Audiovisivo
ភ្នំឧដុង្គ	Oudong
ជនជាតិចារាយ(ខ្មែរលើ)	Jarai
ស្ថាបត្យករខ្មែរ	Architettura della Cambogia
តារាងនៃស៊េរីគណិតវិទ្យា	Lista delle serie matematiche
ប្រាសាទតានៃ	Ta Nei
ចំងាយពីចំនុចមួយទៅបន្ទាត់	Distanza di un punto da un insieme
ចំនួនថេរត្រីកោណមាត្រពិត	Costanti trigonometriche esatte
ជញ្ជាំងក្រហម	Redwall
ខ្មែរឥស្សរៈ	Khmer Issarak
ព្រះរាជាណាចក្រកម្ពុជា (១៩៥៣-១៩៧០)	La Cambogia sotto il regime di Sihanouk
ដប់ប្រាំពីរមេសាជោគជ័យ	Dap Prampi Mesa Chokchey
សមីការតូរីចេល្លី	Equazione di Torricelli
កីឡាចុងបូព៌ាឆ្នាំ១៩១៩	IV Giochi dell'Estremo Oriente
បណ្តុំកន្សោមរ៉ាឌីកាល់	Radicale doppio
កីឡាចុងបូព៌ាឆ្នាំ១៩២១	V Giochi dell'Estremo Oriente
កោណ្ឌញ្ញៈ	Kaundinya
កីឡាចុងបូព៌ាឆ្នាំ១៩៣០	IX Giochi dell'Estremo Oriente
កីឡាចុងបូព៌ាឆ្នាំ១៩២៧	VIII Giochi dell'Estremo Oriente
កីឡាចុងបូព៌ាឆ្នាំ១៩២៣	VI Giochi dell'Estremo Oriente
កីឡាចុងបូព៌ាឆ្នាំ១៩៣៤	X Giochi dell'Estremo Oriente
កត្តាអាំងតេក្រាល	Fattore di integrazione
រដ្ឋាភិបាលចម្រុះកម្ពុជាប្រជាធិបតេយ្យ	Governo di coalizione della Kampuchea Democratica
សញ្ញាជាតិរបស់បណ្ដាប្រជាជាតិនៅអាស៊ី	Stemmi ed emblemi degli Stati asiatici
ប្រាសាទបាតជុំ	Bat Chum
ចំណាត់ថ្នាក់ក្រុម:អត្ថបទខ្លីមិនពេញលេញ	Categoria:Stub
ចំណាត់ថ្នាក់ក្រុម:ទ្វីប	Categoria:Continenti
ចំណាត់ថ្នាក់ក្រុម:ភូមិវិទ្យា	Categoria:Geologia
ចំណាត់ថ្នាក់ក្រុម:យន្តហោះ	Categoria:Aeromobili
ទំព័រគំរូ:ប្រព័ន្ធព្រះអាទិត្យ	Template:Sistema solare
ពីរ៉ាមីត	Piramide (geometria)
ពន្ធតែមប្រិ៍	Imposta di bollo
ជំនួយ:ការកត់ឈ្មោះចូល	Aiuto:Come registrarsi
ទ្រឹស្តីបទអាឡាស៊ី	Teorema di Alasia
គ្រោះមហន្តរាយ	Disastro
វិគីភីឌា:Reference desk	Wikipedia:Oracolo
ទំព័រគំរូ:Authority control	Template:Controllo di autorità
ទំព័រគំរូ:Quote	Template:Citazione
ភ្នំសុមេរុ	Sumeru
ទំព័រគំរូ:Location map Scotland	Template:Mappa di localizzazione/SCO
ទំព័រគំរូ:Location map England	Template:Mappa di localizzazione/ENG
ចំណាត់ថ្នាក់ក្រុម:សេដ្ឋកិច្ច	Categoria:Economia
វិគីភីឌា:សុំប្តូរអត្តនាម	Wikipedia:Cambiare il nome utente
ចំណាត់ថ្នាក់ក្រុម:ជនជាតិ ភាគតិច ក្នុង ប្រទេស កម្ពុជា	Categoria:Gruppi etnici in Cambogia
វិគីភីឌា:Oversight	Wikipedia:Oversight
វិគីភីឌា:IP block exemption	Wikipedia:Esenti dal blocco IP
វិគីភីឌា:រូបយន្ត	Wikipedia:Bot
ចំណាត់ថ្នាក់ក្រុម:Hidden categories	Categoria:Categorie nascoste
អេហ៊្សីប	Egitto
ជំនួយ:ទំព័រគំរូ	Aiuto:Template
វិគីភីឌា:វិគីគម្រោង	Wikipedia:Progetto
ទំព័រគំរូ:Bot	Template:Bot
វិគីភីឌា:អ្វីៗដែលវិគីភីឌាមិនអនុញ្ញាត	Wikipedia:Cosa Wikipedia non è
កាណាដា	Canada
ចំណាត់ថ្នាក់ក្រុម:ប្រទេសអាយឡែន	Categoria:Islanda
វិគីភីឌា:អំពីវិគីភីឌា	Wikipedia:Sala stampa/Wikipedia
ចំណាត់ថ្នាក់ក្រុម:ខ្នាតក្រលាផ្ទៃ	Categoria:Unità di superficie
ជំនួយ:ពាក្យទិព្វ	Aiuto:Direttive
វិគីភីឌា:Database reports	Wikipedia:Elenchi generati offline
ចំណាត់ថ្នាក់ក្រុម:អឺរ៉ុប	Categoria:Europa
ចំណាត់ថ្នាក់ក្រុម:ជំនួយក្នុងវិគីភីឌា	Categoria:Aiuto
វិគីភីឌា:ទំព័រអ្នកប្រើប្រាស់	Wikipedia:Pagina utente
ទំព័រគំរូ:Documentation	Template:Man
វិគីភីឌា:អ្នកប្រើប្រាស់	Wikipedia:Livelli di accesso degli utenti
វិគីភីឌា:Protection policy	Wikipedia:Politica di protezione delle pagine
វិគីភីឌា:WikiLove	Wikipedia:Wikilove
វិគីភីឌា:Userboxes	Wikipedia:Info utente
វិគីភីឌា:ហត្ថលេខា	Aiuto:Firma
វិគីភីឌា:អត្ថបទខ្លីមិនពេញលេញ	Aiuto:Abbozzo
វិគីភីឌា:លក្ខណៈវិនិច្ឆ័យនៃលុបជាបន្ទាន់	Wikipedia:Cancellazioni immediate
វិគីភីឌា:Most wanted articles	Wikipedia:Richieste di nuove voci
្ឞ្ញ ហ្សអិ-អិអៀ	Sung Jae-gi
ទំព័រគំរូ:Softredirect	Template:Soft redirect
ទំព័រគំរូ:លុបជាបន្ទាន់	Template:Cancella subito
ក្លោងទ្វារ:ចិន	Portale:Cina
វិគីភីឌា:វិគីគម្រោង ជីវប្រវត្តិ	Progetto:Biografie
ទំព័រគំរូ:Succession	Template:Box successione
របៀបសសេរស្គ្រីប	Soggetto (cinema)
ចំណាត់ថ្នាក់ក្រុម:ភាសា	Categoria:Lingue
ចំណាត់ថ្នាក់ក្រុម:វេយ្យាករណ៍	Categoria:Grammatica
ចំណាត់ថ្នាក់ក្រុម:វិគីភីឌា	Categoria:Wikipedia
វិគីភីឌា:ការបដិសេធ ទូទៅ	Wikipedia:Avvertenze generali
ជំនួយ:ចំណាត់ថ្នាក់ក្រុម	Aiuto:Categorie
វិគីភីឌា:សារទំព័រគំរូ	Aiuto:Avvisi
វិគីភីឌា:អសង្ស័យកម្ម	Aiuto:Manuale di stile
Portal:Contents/Portals	Portale:Portali
ទំព័រគំរូ:Navbox	Template:Navbox
ជំនួយ:រូបមន្ត	Aiuto:Formule matematiche TeX
ជំនួយ:តំណភ្ជាប់	Aiuto:Link
ទំព័រគំរូ:Citation needed	Template:Citazione necessaria
តំបន់ពាណិជ្ជកម្មសេរី	Area di libero scambio
ទំព័រគំរូ:Error	Template:Errore template
ចំណាត់ថ្នាក់ក្រុម:Flag templates	Categoria:Template bandierine
ទំព័រគំរូ:=	Template:=
ទំព័រគំរូ:Navbar	Template:Tnavbar
ទំព័រគំរូ:Loop	Template:Ciclo
ទំព័រគំរូ:Void	Template:Void
ទំព័រគំរូ:Key press	Template:Tasto
ទំព័រគំរូ:Okina	Template:Okina
ទំព័រគំរូ:Sc	Template:Maiuscoletto
ទំព័រគំរូ:Clear	Template:Clear
ទំព័រគំរូ:Col-break	Template:Colonne spezza
ទំព័រគំរូ:Col-end	Template:Colonne fine
ទំព័រគំរូ:Trim	Template:Str trim
ទំព័រគំរូ:Color	Template:Colore
ទំព័រគំរូ:Nowrap	Template:Tutto attaccato
ទំព័រគំរូ:Bots	Template:Bots
ទំព័រគំរូ:Abbr	Template:Descrizione comando
វិគីភីឌា:វិគីគម្រោង ទំព័រគំរូ	Progetto:Coordinamento/Template
ចំណាត់ថ្នាក់ក្រុម:ខ្សែកោង	Categoria:Curve
ទំព័រគំរូ:Babel	Template:Babel
ទំព័រគំរូ:Commons	Template:Commons
ទំព័រគំរូ:Link GA	Template:Link VdQ
ទំព័រគំរូ:Reflist	Template:References
ទំព័រគំរូ:NavPeriodicTable	Template:Infobox elemento chimico/mini tavola periodica
វិគីភីឌា:Citing sources	Aiuto:Uso delle fonti
ទំព័រគំរូ:អត្ថបទខ្លីមិនពេញលេញ	Template:S
ទំព័រគំរូ:User af-1	Template:Utente af-1
ទំព័រគំរូ:User als-1	Template:Utente als-1
ទំព័រគំរូ:User az	Template:Utente az
ទំព័រគំរូ:See also	Template:Vedi anche
ទំព័រគំរូ:User de	Template:Utente de
ទំព័រគំរូ:User de-1	Template:Utente de-1
ទំព័រគំរូ:User et-1	Template:Utente et-1
ទំព័រគំរូ:User el	Template:Utente el
ទំព័រគំរូ:User es	Template:Utente es
ទំព័រគំរូ:User de-3	Template:Utente de-3
ទំព័រគំរូ:User en-3	Template:Utente en-3
ទំព័រគំរូ:User en-1	Template:Utente en-1
ទំព័រគំរូ:User en-2	Template:Utente en-2
ទំព័រគំរូ:User en-4	Template:Utente en-4
ទំព័រគំរូ:User fi	Template:Utente fi
ទំព័រគំរូ:User en-0	Template:Utente en-0
ទំព័រគំរូ:User es-4	Template:Utente es-4
ទំព័រគំរូ:User en	Template:Utente en
ទំព័រគំរូ:User de-2	Template:Utente de-2
ទំព័រគំរូ:User es-1	Template:Utente es-1
ទំព័រគំរូ:User fa	Template:Utente fa
ទំព័រគំរូ:User fr-1	Template:Utente fr-1
ទំព័រគំរូ:User id-3	Template:Utente id-3
ទំព័រគំរូ:User it-3	Template:Utente it-3
ទំព័រគំរូ:User tr-2	Template:Utente tr-2
ទំព័រគំរូ:User fr-2	Template:Utente fr-2
ទំព័រគំរូ:User tr	Template:Utente tr
ទំព័រគំរូ:User ja	Template:Utente ja
ទំព័រគំរូ:User ja-1	Template:Utente ja-1
ទំព័រគំរូ:User it-1	Template:Utente it-1
ទំព័រគំរូ:User fr	Template:Utente fr
ទំព័រគំរូ:Location map/Info	Template:Mappa di localizzazione/info
ចំណាត់ថ្នាក់ក្រុម:Navigational boxes	Categoria:Template di navigazione
ចំណាត់ថ្នាក់ក្រុម:អាស៊ី	Categoria:Asia
ចំណាត់ថ្នាក់ក្រុម:User uk-N	Categoria:Utenti uk-M
ទំព័រគំរូ:Intricate template	Template:Template complesso
ទំព័រគំរូ:Lang-ja	Template:Lang-ja
ទំព័រគំរូ:Football squad player	Template:Football squad player
ទំព័រគំរូ:Mod	Template:Mod
ទំព័រគំរូ:Now Commons	Template:NowCommons
ទំព័រគំរូ:User it	Template:Utente it
ទំព័រគំរូ:User uk	Template:Utente uk
ទំព័រគំរូ:User es-2	Template:Utente es-2
ទំព័រគំរូ:ស្វាគមន៍	Template:Benvenuto
ទំព័រគំរូ:គម្រោងវិគីជាបងប្អូន	Template:PaginaPrincipale/Progetti
ចំណាត់ថ្នាក់ក្រុម:External link templates	Categoria:Template collegamenti esterni
ទំព័រគំរូ:Month header	Template:Mesi
ទំព័រគំរូ:USA	Template:USA
ចំណាត់ថ្នាក់ក្រុម:User ms	Categoria:Utenti ms
ទំព័រគំរូ:Football kit	Template:Divisa Calcio
ចំណាត់ថ្នាក់ក្រុម:User fr-1	Categoria:Utenti fr-1
ទំព័រគំរូ:Wikiquote	Template:Wikiquote
ទំព័រគំរូ:Image label	Template:Etichetta immagine
ទំព័រគំរូ:Category tree	Template:Albero categorie
ទំព័រគំរូ:Stub category	Template:Categoria stub
ទំព័រគំរូ:Ja icon	Template:Ja
ទំព័រគំរូ:Infobox television	Template:FictionTV
ទំព័រគំរូ:Infobox musical artist	Template:Artista musicale
ទំព័រគំរូ:ទិន្នន័យ​នៃប្រទេសប៉ាឡេស្ទីន	Template:PSE
ទំព័រគំរូ:Subatomic particle	Template:Particella subatomica
ទំព័រគំរូ:Sidebar	Template:Sidebar
ទំព័រគំរូ:In use	Template:WIP
ទំព័រគំរូ:Es icon	Template:Es
ទំព័រគំរូ:Ambox	Template:Avviso
ទំព័រគំរូ:ប្រអប់ព័ត៌មាន មន្ទីរពេទ្យ	Template:Ospedale
ទំព័រគំរូ:Image requested	Template:Richiesta immagini
ទំព័រគំរូ:ទិន្នន័យ​នៃប្រទេសគាហ្គីស្ថាន	Template:KGZ
ទំព័រគំរូ:Userboxbottom	Template:BabelfishBottom
ទំព័រគំរូ:Copy to Wikimedia Commons	Template:Immagine commons
ទំព័រគំរូ:ប្រអប់ព័ត៌មាន ប្រទេស	Template:Stato
ទំព័រគំរូ:Max	Template:Max
ទំព័រគំរូ:Infobox software	Template:Software
ទំព័រគំរូ:Infobox airline	Template:Infobox compagnia aerea
ទំព័រគំរូ:Wide image	Template:Immagine grande
ទំព័រគំរូ:ប្រអប់ព័ត៌មាន ជម្លោះយោធា	Template:Infobox conflitto
វិគីភីឌា:សំណួរ	Aiuto:Dove fare una domanda
ទំព័រគំរូ:Redirect4	Template:Str left
ទំព័រគំរូ:Pagelist	Template:Lista pagine
ទំព័រគំរូ:Resolved	Template:Fatto
ទំព័រគំរូ:Str sub long	Template:Str sub
ទំព័រគំរូ:ទិន្នន័យ​នៃប្រទេសហ្វីលីពីន	Template:PHL
ទំព័រគំរូ:ប្រអប់ព័ត៌មាន គណបក្សនយោបាយ	Template:Partito politico
ទំព័រគំរូ:Expand section	Template:S sezione
ទំព័រគំរូ:ប្រអប់ព័ត៌មាន ល្បែងវីដេអូ	Template:Gamebox
ទំព័រគំរូ:S-start	Template:S-inizio
ទំព័រគំរូ:IsLeapYear	Template:Bisestile
ទំព័រគំរូ:Age in years and days	Template:Età e giorni
ទំព័រគំរូ:Nom	Template:Nomination
ទំព័រគំរូ:Cleanup	Template:Organizzare
ទំព័រគំរូ:ប្រអប់ព័ត៌មាន សាកលវិទ្យាល័យ	Template:Università
ទំព័រគំរូ:Cite journal	Template:Cita pubblicazione
ទំព័រគំរូ:ទិន្នន័យ​នៃប្រទេសប្រ៊ុយណេ	Template:BRN
ទំព័រគំរូ:User browser:Firefox	Utente:Wuzihong/Template:Utenti che usavano Firefox
ទំព័រគំរូ:User es-0	Template:Utente es-0
ទំព័រគំរូ:Time ago	Template:Tempo trascorso
ទំព័រគំរូ:Familytree	Template:Albero genealogico
ទំព័រគំរូ:Featured article	Template:Vetrina
ទំព័រគំរូ:Infobox monarch	Template:Monarca
ទំព័រគំរូ:Decdeg	Template:Gms-dec
ចំណាត់ថ្នាក់ក្រុម:User en-4	Categoria:Utenti en-4
ចំណាត់ថ្នាក់ក្រុម:User en	Categoria:Utenti en
ចំណាត់ថ្នាក់ក្រុម:User zh	Categoria:Utenti zh
ចំណាត់ថ្នាក់ក្រុម:User zh-N	Categoria:Utenti zh-M
ចំណាត់ថ្នាក់ក្រុម:User en-2	Categoria:Utenti en-2
ទំព័រគំរូ:ប្រអប់ព័ត៌មាន	Template:Infobox
ទំព័រគំរូ:Infobox instrument	Template:Strumento musicale
ទំព័រគំរូ:TOC right	Template:TOCright
ទំព័រគំរូ:RankedMedalTable	Template:IntestazioneMedagliere
ទំព័រគំរូ:User zh	Template:Utente zh
ទំព័រគំរូ:Legend	Template:Legenda
ទំព័រគំរូ:ប្រអប់ព័ត៌មាន បណ្ណាល័យ	Template:Biblioteca
ទំព័រគំរូ:Cite web	Template:Cita web
ទំព័រគំរូ:YouTube	Template:YouTube
ទំព័រគំរូ:Current	Template:In corso
ទំព័រគំរូ:Wikipedia-screenshot	Template:Wikimedia-screenshot
ទំព័រគំរូ:Won	Template:Won
ទំព័រគំរូ:Tnavbar-collapsible	Template:Tnavbar-collapsible
ទំព័រគំរូ:Pp-template	Template:Pp-template
ទំព័រគំរូ:Min	Template:Min
ទំព័រគំរូ:Bar box	Template:Tabella a barre
ទំព័រគំរូ:Chem	Template:Chem
ទំព័រគំរូ:Lang-sr	Template:Serbo
ទំព័រគំរូ:User ru	Template:Utente ru
ទំព័រគំរូ:IPA	Template:IPA
ទំព័រគំរូ:អត្ថន័យដទៃទៀត	Template:Nota disambigua
ទំព័រគំរូ:SeptemberCalendar	Template:Settembre
ទំព័រគំរូ:Navbox subgroup	Template:Navbox subgroup
ទំព័រគំរូ:Birth year and age	Template:Calcola età
ទំព័រគំរូ:List of African capitals	Template:Capitali dell'Africa
ទំព័រគំរូ:ប្រអប់ព័ត៌មាន ក្រុមជនជាតិ	Template:Popolo
ទំព័រគំរូ:Archive box	Template:Archivio
ទំព័រគំរូ:MONTHNAME	Template:MONTHNAME
វិគីភីឌា:Text of GNU Free Documentation License	Wikipedia:Testo della GNU Free Documentation License
ទំព័រគំរូ:Sisterlinks	Template:Interprogetto
ទំព័រគំរូ:ប្រអប់ព័ត៌មាន តំបន់ការពារ	Template:Area protetta
ទំព័រគំរូ:Border	Template:Border
ទំព័រគំរូ:MONTHNUMBER	Template:MONTHNUMBER
ចំណាត់ថ្នាក់ក្រុម:People stubs	Categoria:Stub - biografie
ទំព័រគំរូ:Icon	Template:Icona
ចំណាត់ថ្នាក់ក្រុម:ជ័យលាភីរង្វាន់ណូបែល ផ្នែករូបវិទ្យា	Categoria:Vincitori del premio Nobel per la fisica
ទំព័រគំរូ:GeoGroup	Template:GeoGroup
ទំព័រគំរូ:Wikify	Template:W
ទំព័រគំរូ:Hidden begin	Template:Cassetto inizio
ទំព័រគំរូ:ParmPart	Template:ParmPart
ទំព័រគំរូ:Infobox OS	Template:Sistema operativo
ទំព័រគំរូ:ប្រអប់ព័ត៌មាន សៀវភៅ	Template:Libro
ទំព័រគំរូ:Compact periodic table	Template:Tavola periodica
ទំព័រគំរូ:Lang-fa	Template:Farsi
ទំព័រគំរូ:ទិន្នន័យ​នៃប្រទេសម៉ាឡេស៊ី	Template:MYS
ទំព័រគំរូ:Infobox website	Template:Sito web
ទំព័រគំរូ:Globalize	Template:L
ទំព័រគំរូ:Image label end	Template:Etichetta immagine fine
ទំព័រគំរូ:Uncategorized	Template:Categorizzare
ទំព័រគំរូ:ទិន្នន័យ​នៃប្រទេសឥណ្ឌូនេស៊ី	Template:IDN
ទំព័រគំរូ:Talk header for guidelines	Template:Discussione
ទំព័រគំរូ:CcTLD	Template:CcTLD
ទំព័រគំរូ:Cc-by-2.0	Template:Cc-by-2.0
ទំព័រគំរូ:List of Asian capitals by region	Template:Capitali dell'Asia
ទំព័រគំរូ:ប្រអប់ព័ត៌មានទីកន្លែងកេរដំណែលពិភពលោក	Template:UNESCO
ទំព័រគំរូ:Str len	Template:Str len
ទំព័រគំរូ:Purge	Template:Purga
ទំព័រគំរូ:Empty category	Template:Servizio vuota
ទំព័រគំរូ:Pre2	Template:Pre2
ទំព័រគំរូ:Lang-la	Template:Latino
ទំព័រគំរូ:ប្រអប់ព័ត៌មាន អាគារ	Template:Edificio civile
ទំព័រគំរូ:'	Template:'
ទំព័រគំរូ:Location map USA	Template:Mappa di localizzazione/USA
ទំព័រគំរូ:Lang-el	Template:Lang-el
ទំព័រគំរូ:Chessgames player	Template:Chessgames
ទំព័រគំរូ:ទិន្នន័យ​នៃប្រទេសអារ៉ាប៊ីសាអូឌីត	Template:SAU
ទំព័រគំរូ:User page	Template:Pagina utente
ទំព័រគំរូ:DE	Template:DEU
ទំព័រគំរូ:Stack	Template:Stack
ទំព័រគំរូ:Infobox Christian leader	Template:Papa della Chiesa cattolica
ទំព័រគំរូ:User	Template:Utente
ទំព័រគំរូ:Spoken Wikipedia	Template:Wikipedia parlata
ទំព័រគំរូ:វិគីភីឌាភាសា	Template:Wikipedia
ទំព័រគំរូ:Clarify	Template:Chiarire
ទំព័រគំរូ:Refimprove	Template:F
ទំព័រគំរូ:Lorem ipsum	Template:Lorem ipsum
ទំព័រគំរូ:ស្នើសុំប្ដូរឈ្មោះ	Template:Richiesta ridenominazione
ទំព័រគំរូ:Image label small	Template:Etichetta immagine piccola
ទំព័រគំរូ:Featured article candidates	Template:Vetrina inserimento
ទំព័រគំរូ:Nihongo	Template:Nihongo
ទំព័រគំរូ:User fr-3	Template:Utente fr-3
ទំព័រគំរូ:PD-because	Template:PD-Perché
ទំព័រគំរូ:Th icon	Template:Th
ទំព័រគំរូ:Cc-by	Template:Cc-by-1.0
ទំព័រគំរូ:Tag	Template:Tag
ទំព័រគំរូ:Infobox former country	Template:Stato storico
ទំព័រគំរូ:JPN	Template:JPN
ទំព័រគំរូ:ភូមិភាគទាំង៩របស់ជប៉ុន	Template:Giappone geografia
ជំនួយ:តារាង	Aiuto:Tabelle
ទំព័រគំរូ:ទិន្នន័យ​នៃប្រទេសប៉ាគីស្ថាន	Template:PAK
ទំព័រគំរូ:Age in days nts	Template:Età in giorni
ទំព័រគំរូ:Nations at the 2008 Summer Olympics	Template:Nazioni ai Giochi della XXIX Olimpiade
ទំព័រគំរូ:JULIANDAY	Template:JULIANDAY
ទំព័រគំរូ:Disagree	Template:Contrario
ទំព័រគំរូ:DNB portal	Template:DNB-Portal
ទំព័រគំរូ:Talkarchive	Template:Avviso archivio
ទំព័រគំរូ:Lt	Template:Lt
ទំព័រគំរូ:ទិន្នន័យ​នៃប្រទេសអ៊ីរ៉ង់	Template:IRN
ទំព័រគំរូ:ទិន្នន័យ​នៃប្រទេសហ្សកដង់	Template:JOR
ទំព័រគំរូ:Bibleverse	Template:Passo biblico
ទំព័រគំរូ:ទិន្នន័យ​នៃប្រទេសហុងកុង	Template:HKG
ទំព័រគំរូ:ទិន្នន័យ​នៃប្រទេសកូរ៉េខាងជើង	Template:PRK
ទំព័រគំរូ:Infobox continent	Template:Regione geografica
ទំព័រគំរូ:Date	Template:Date
ទំព័រគំរូ:BHU	Template:BTN
ទំព័រគំរូ:ទិន្នន័យ​នៃប្រទេសសិង្ហបុរី	Template:SGP
ទំព័រគំរូ:ទិន្នន័យ​នៃប្រទេសឥណ្ឌា	Template:IND
ទំព័រគំរូ:ទិន្នន័យ​នៃប្រទេសម៉ាកាវ	Template:MAC
ទំព័រគំរូ:សបា្ដហ៍	Template:Giorni della settimana
ទំព័រគំរូ:CURRENTJULIANDAY	Template:CURRENTJULIANDAY
ចំណាត់ថ្នាក់ក្រុម:User ja-N	Categoria:Utenti ja-M
ទំព័រគំរូ:Largest cities	Template:Città principali
ទំព័រគំរូ:PDFlink	Template:Pdf
ទំព័រគំរូ:Ca icon	Template:Ca
ទំព័រគំរូ:Lang-ru	Template:Russo
ទំព័រគំរូ:Infobox saint	Template:Santo
ទំព័រគំរូ:FebruaryCalendar	Template:Febbraio
ទំព័រគំរូ:Hidden end	Template:Cassetto fine
ទំព័រគំរូ:ណែនាំ	Template:Disambigua
ទំព័រគំរូ:No	Template:Non fatto
ចំណាត់ថ្នាក់ក្រុម:ទំព័រគំរូ ប្រអប់ព័ត៌មាន	Categoria:Template sinottici
ចំណាត់ថ្នាក់ក្រុម:Lists of flags	Categoria:Liste di bandiere
ទំព័រគំរូ:Select skin	Template:Seleziona skin
ចំណាត់ថ្នាក់ក្រុម:ហិរញ្ញវត្ថុសាធារណៈ	Categoria:Finanza pubblica
ចំណាត់ថ្នាក់ក្រុម:អ្នកថតរូប	Categoria:Fotografia
ចំណាត់ថ្នាក់ក្រុម:យន្តហោះយោធា	Categoria:Aerei militari
ទំព័រគំរូ:LAO	Template:LAO
ទំព័រគំរូ:User zh-min-nan	Template:Utente zh-min-nan
ទំព័រគំរូ:User zh-min-nan-1	Template:Utente zh-min-nan-1
ទំព័រគំរូ:GRC	Template:GRC
ទំព័រគំរូ:PRT	Template:PRT
ទំព័រគំរូ:ទិន្នន័យ​នៃប្រទេសបង់ក្លាដែស្ស	Template:BGD
ទំព័រគំរូ:States of Austria	Template:Länder austriaci
ចំណាត់ថ្នាក់ក្រុម:អង្គការមិនរកប្រាក់កំរៃ	Categoria:Associazioni non profit
ទំព័រគំរូ:Lang-uk	Template:Ucraino
ទំព័រគំរូ:KHM	Template:KHM
ទំព័រគំរូ:ប្រអប់ព័ត៌មាន អង្គការ	Template:Organizzazione
ទំព័រគំរូ:MNE	Template:MNE
ទំព័រគំរូ:Category TOC	Template:Indice categoria
ទំព័រគំរូ:ទិន្នន័យ​នៃប្រទេសមីយ៉ាន់ម៉ា	Template:MMR
ទំព័រគំរូ:ទិន្នន័យ​នៃប្រទេសកូរ៉េខាងត្បូង	Template:KOR
ទំព័រគំរូ:User it-2	Template:Utente it-2
ទំព័រគំរូ:Val	Template:M
ទំព័រគំរូ:មេកានិចក្លាស់សិច	Template:Meccanica classica
ទំព័រគំរូ:Superimpose	Template:Sovraimmagine
ទំព័រគំរូ:FRA	Template:FRA
ទំព័រគំរូ:Age	Template:Età
ទំព័រគំរូ:Infobox person	Template:Bio
ទំព័រគំរូ:List of European capitals by region	Template:Capitali degli Stati e dei Territori Autonomi d'Europa
ទំព័រគំរូ:Legend-line	Template:Legenda-linea
ទំព័រគំរូ:Election table	Template:Electiontable
ទំព័រគំរូ:Coord	Template:Coord
ទំព័រគំរូ:POV	Template:P
ចំណាត់ថ្នាក់ក្រុម:20th-century births	Categoria:Nati nel XX secolo
ទំព័រគំរូ:Dmoz	Template:Dmoz
ចំណាត់ថ្នាក់ក្រុម:ពហុកោណ	Categoria:Poligoni
ទំព័រគំរូ:Fide	Template:Fide
ទំព័រគំរូ:User lb-1	Template:Utente lb-1
ទំព័រគំរូ:User fr-4	Template:Utente fr-4
ទំព័រគំរូ:អាស៊ីហ្គេម	Template:Giochi asiatici storico
ទំព័រគំរូ:User la-1	Template:Utente la-1
ទំព័រគំរូ:ហិរញ្ញវត្ថុសាធារណៈ	Template:Finanza pubblica
ចំណាត់ថ្នាក់ក្រុម:ឯកសារអំពី ទំព័រគំរូ	Categoria:Manuali dei template
ចំណាត់ថ្នាក់ក្រុម:អត្ថបទខ្លីមិនពេញលេញ អំពីកម្ពុជា	Categoria:Stub - Cambogia
ចំណាត់ថ្នាក់ក្រុម:User et	Categoria:Utenti et
ចំណាត់ថ្នាក់ក្រុម:User fr	Categoria:Utenti fr
ចំណាត់ថ្នាក់ក្រុម:User id	Categoria:Utenti id
ចំណាត់ថ្នាក់ក្រុម:User ja	Categoria:Utenti ja
ចំណាត់ថ្នាក់ក្រុម:User km	Categoria:Utenti km
ចំណាត់ថ្នាក់ក្រុម:User la	Categoria:Utenti la
ចំណាត់ថ្នាក់ក្រុម:User li	Categoria:Utenti li
ចំណាត់ថ្នាក់ក្រុម:User sv	Categoria:Utenti sv
ចំណាត់ថ្នាក់ក្រុម:User th	Categoria:Utenti th
ចំណាត់ថ្នាក់ក្រុម:User fr-3	Categoria:Utenti fr-3
ចំណាត់ថ្នាក់ក្រុម:User it-3	Categoria:Utenti it-3
ចំណាត់ថ្នាក់ក្រុម:User ja-3	Categoria:Utenti ja-3
ចំណាត់ថ្នាក់ក្រុម:User tr-3	Categoria:Utenti tr-3
ចំណាត់ថ្នាក់ក្រុម:User et-1	Categoria:Utenti et-1
ចំណាត់ថ្នាក់ក្រុម:User li-1	Categoria:Utenti li-1
ចំណាត់ថ្នាក់ក្រុម:User nl-1	Categoria:Utenti nl-1
ចំណាត់ថ្នាក់ក្រុម:User tr-1	Categoria:Utenti tr-1
ចំណាត់ថ្នាក់ក្រុម:User fr-4	Categoria:Utenti fr-4
ចំណាត់ថ្នាក់ក្រុម:User it-4	Categoria:Utenti it-4
ចំណាត់ថ្នាក់ក្រុម:User fr-2	Categoria:Utenti fr-2
ចំណាត់ថ្នាក់ក្រុម:User it-2	Categoria:Utenti it-2
ចំណាត់ថ្នាក់ក្រុម:User ja-2	Categoria:Utenti ja-2
ចំណាត់ថ្នាក់ក្រុម:User la-2	Categoria:Utenti la-2
ចំណាត់ថ្នាក់ក្រុម:User tr-2	Categoria:Utenti tr-2
ចំណាត់ថ្នាក់ក្រុម:User fr-N	Categoria:Utenti fr-M
ចំណាត់ថ្នាក់ក្រុម:User it-N	Categoria:Utenti it-M
ចំណាត់ថ្នាក់ក្រុម:User nl-N	Categoria:Utenti nl-M
ចំណាត់ថ្នាក់ក្រុម:User ru-N	Categoria:Utenti ru-M
ចំណាត់ថ្នាក់ក្រុម:កំសាន្ត	Categoria:Intrattenimento
ចំណាត់ថ្នាក់ក្រុម:User af	Categoria:Utenti af
ចំណាត់ថ្នាក់ក្រុម:User af-1	Categoria:Utenti af-1
ចំណាត់ថ្នាក់ក្រុម:User bar	Categoria:Utenti bar
ចំណាត់ថ្នាក់ក្រុម:កោះ	Categoria:Isole
ចំណាត់ថ្នាក់ក្រុម:User de	Categoria:Utenti de
ទំព័រគំរូ:Calendar	Template:Calendario anno
ចំណាត់ថ្នាក់ក្រុម:User de-2	Categoria:Utenti de-2
ចំណាត់ថ្នាក់ក្រុម:User de-3	Categoria:Utenti de-3
ចំណាត់ថ្នាក់ក្រុម:User de-4	Categoria:Utenti de-4
ចំណាត់ថ្នាក់ក្រុម:User de-N	Categoria:Utenti de-M
ចំណាត់ថ្នាក់ក្រុម:User el	Categoria:Utenti el
ចំណាត់ថ្នាក់ក្រុម:User en-3	Categoria:Utenti en-3
ចំណាត់ថ្នាក់ក្រុម:User en-N	Categoria:Utenti en-M
ចំណាត់ថ្នាក់ក្រុម:User es	Categoria:Utenti es
ចំណាត់ថ្នាក់ក្រុម:User es-1	Categoria:Utenti es-1
ចំណាត់ថ្នាក់ក្រុម:User es-2	Categoria:Utenti es-2
ចំណាត់ថ្នាក់ក្រុម:User es-4	Categoria:Utenti es-4
ចំណាត់ថ្នាក់ក្រុម:User es-N	Categoria:Utenti es-M
ចំណាត់ថ្នាក់ក្រុម:User fi	Categoria:Utenti fi
ចំណាត់ថ្នាក់ក្រុម:User fi-N	Categoria:Utenti fi-M
ចំណាត់ថ្នាក់ក្រុម:User gsw	Categoria:Utenti gsw
ទំព័រគំរូ:N/a	Template:ND
ចំណាត់ថ្នាក់ក្រុម:User id-1	Categoria:Utenti id-1
ចំណាត់ថ្នាក់ក្រុម:User id-2	Categoria:Utenti id-2
ចំណាត់ថ្នាក់ក្រុម:User id-3	Categoria:Utenti id-3
ទំព័រគំរូ:Beijing	Template:Suddivisioni Pechino
ទំព័រគំរូ:Multiple image	Template:Immagine multipla
ចំណាត់ថ្នាក់ក្រុម:ធរណីមាត្រ	Categoria:Geometria
ទំព័រគំរូ:ប្រអប់ព័ត៌មាន រោគ-ជំងឺ	Template:Infobox malattia
ទំព័រគំរូ:Weather box	Template:ClimaAnnuale
ចំណាត់ថ្នាក់ក្រុម:User it	Categoria:Utenti it
ចំណាត់ថ្នាក់ក្រុម:User it-1	Categoria:Utenti it-1
ចំណាត់ថ្នាក់ក្រុម:User ja-1	Categoria:Utenti ja-1
ចំណាត់ថ្នាក់ក្រុម:User km-N	Categoria:Utenti km-M
ចំណាត់ថ្នាក់ក្រុម:User ko	Categoria:Utenti ko
ចំណាត់ថ្នាក់ក្រុម:User ko-1	Categoria:Utenti ko-1
ចំណាត់ថ្នាក់ក្រុម:User ko-2	Categoria:Utenti ko-2
ចំណាត់ថ្នាក់ក្រុម:User ko-3	Categoria:Utenti ko-3
ចំណាត់ថ្នាក់ក្រុម:User ksh	Categoria:Utenti ksh
ចំណាត់ថ្នាក់ក្រុម:User ksh-N	Categoria:Utenti ksh-M
ចំណាត់ថ្នាក់ក្រុម:User la-1	Categoria:Utenti la-1
ចំណាត់ថ្នាក់ក្រុម:User lb	Categoria:Utenti lb
ចំណាត់ថ្នាក់ក្រុម:User lb-1	Categoria:Utenti lb-1
ទំព័រគំរូ:ប្រអប់ព័ត៌មាន រូបិយវត្ថុ	Template:Valuta
ទំព័រគំរូ:Infobox programming language	Template:Linguaggio di programmazione
ទំព័រគំរូ:He icon	Template:He
បញ្ជីរាយនាម ជ័យលាភីរង្វាន់ណូបែល ផ្នែកអក្សរសាស្ត្រ	Vincitori del premio Nobel per la letteratura
វិគីភីឌា:Maintenance	Aiuto:Lavoro sporco
ទំព័រគំរូ:Information	Template:Informazioni file
ចំណាត់ថ្នាក់ក្រុម:អត្ថបទវិគីភីឌាដែលត្រូវការការបកប្រែ	Categoria:Tradurre
ចំណាត់ថ្នាក់ក្រុម:User ru-1	Categoria:Utenti ru-1
ទំព័រគំរូ:TOC limit	Template:TOClimit
វិគីភីឌា:បាបេល	Wikipedia:Babel
ទំព័រគំរូ:Tdeprecated	Template:Template obsoleto
ទំព័រគំរូ:Infobox particle	Template:Infobox particella
ទំព័រគំរូ:NovemberCalendar	Template:Novembre
ចំណាត់ថ្នាក់ក្រុម:User ms-2	Categoria:Utenti ms-2
ចំណាត់ថ្នាក់ក្រុម:សមុទ្រ	Categoria:Mari
ទំព័រគំរូ:ISO standards	Template:Standard ISO
ទំព័រគំរូ:MayCalendar	Template:Maggio
ទំព័រគំរូ:Lang-ko	Template:Hanguk
ចំណាត់ថ្នាក់ក្រុម:User nds	Categoria:Utenti nds
ទំព័រគំរូ:Sect1911	Template:Britannica 1911
ចំណាត់ថ្នាក់ក្រុម:User nds-1	Categoria:Utenti nds-1
វិគីភីឌា:WikiProject Computing	Progetto:Informatica
ចំណាត់ថ្នាក់ក្រុម:អង្គការអន្តរជាតិ	Categoria:Organizzazioni internazionali
ជំនួយ:សៀវភៅ	Aiuto:Libri
ចំណាត់ថ្នាក់ក្រុម:សមីការឌីផេរ៉ង់ស្យែល	Categoria:Equazioni differenziali
ចំណាត់ថ្នាក់ក្រុម:ខេត្តក្រុងខ្មែរ	Categoria:Province della Cambogia
ចំណាត់ថ្នាក់ក្រុម:User zh-min-nan	Categoria:Utenti zh-min-nan
ទំព័រគំរូ:Release date and age	Template:Data e tempo
ចំណាត់ថ្នាក់ក្រុម:User zh-min-nan-3	Categoria:Utenti zh-min-nan-3
ទំព័រគំរូ:Ms icon	Template:Ms
ចំណាត់ថ្នាក់ក្រុម:ឧទ្ធម្ភាគចក្រ	Categoria:Elicotteri
ចំណាត់ថ្នាក់ក្រុម:វិទ្យាសាស្ត្រសង្គម	Categoria:Scienze sociali
ឈាន	Dhyāna
ទំព័រគំរូ:JanuaryCalendar	Template:Gennaio
ចំណាត់ថ្នាក់ក្រុម:ឆ្នាំកំណើត ១៩៥១	Categoria:Nati nel 1951
ទំព័រគំរូ:Zh icon	Template:Zh
ទំព័រគំរូ:Infobox government agency	Template:Organo governativo
វិគីភីឌា:Tools	Aiuto:Strumenti
ទំព័រគំរូ:User ru-2	Template:Utente ru-2
ចំណាត់ថ្នាក់ក្រុម:User ru	Categoria:Utenti ru
ចំណាត់ថ្នាក់ក្រុម:User ru-2	Categoria:Utenti ru-2
ចំណាត់ថ្នាក់ក្រុម:User ru-3	Categoria:Utenti ru-3
ចំណាត់ថ្នាក់ក្រុម:វត្តអារាមព្រះពុទ្ធសាសនា	Categoria:Templi buddhisti
ទំព័រគំរូ:Apollo program	Template:Navigazione Apollo
ចំណាត់ថ្នាក់ក្រុម:User th-1	Categoria:Utenti th-1
ចំណាត់ថ្នាក់ក្រុម:User th-N	Categoria:Utenti th-M
ចំណាត់ថ្នាក់ក្រុម:User tr	Categoria:Utenti tr
ចំណាត់ថ្នាក់ក្រុម:User tr-0	Categoria:Utenti tr-0
ចំណាត់ថ្នាក់ក្រុម:User tr-4	Categoria:Utenti tr-4
ចំណាត់ថ្នាក់ក្រុម:User tr-N	Categoria:Utenti tr-M
ចំណាត់ថ្នាក់ក្រុម:User vls	Categoria:Utenti vls
ចំណាត់ថ្នាក់ក្រុម:User vls-1	Categoria:Utenti vls-1
ទំព័រគំរូ:En icon	Template:En
ទំព័រគំរូ:Nay	Template:NO
ទំព័រគំរូ:Spaces	Template:Spazi
ទំព័រគំរូ:ប្រអប់ភាសា	Template:Lang
ទំព័រគំរូ:In-universe	Template:Finzione
ទំព័រគំរូ:Infobox Olympics Cambodia	Template:NazioneGiochiOlimpici/Cambogia
ជំនួយ:Files	Aiuto:Suoni
ទំព័រគំរូ:Str index	Template:Str index
ទំព័រគំរូ:Self	Template:Self
ទំព័រគំរូ:Alabama	Template:Alabama
ទំព័រគំរូ:Angkorian sites	Template:Siti angkoriani
ទំព័រគំរូ:Humanities-footer	Template:Discipline umanistiche
ទំព័រគំរូ:Copyright by Wikimedia	Template:CopyrightByWikimedia
ទំព័រគំរូ:AugustCalendar	Template:Agosto
ចំណាត់ថ្នាក់ក្រុម:ធរណីមាត្រត្រីកោណ	Categoria:Geometria del triangolo
ទំព័រគំរូ:Bar percent	Template:Barra percentuale
ទំព័រគំរូ:Str find	Template:Str find
ទំព័រគំរូ:ពុទ្ធស្ថាន	Template:LuoghiBuddha
ទំព័រគំរូ:Fr icon	Template:Fr
ទំព័រគំរូ:Ko icon	Template:Ko
ទំព័រគំរូ:EST	Template:EST
ទំព័រគំរូ:Football squad end	Template:Calciatore in rosa/fine
ទំព័រគំរូ:ទិន្នន័យ​នៃប្រទេសរុស្ស៊ី	Template:RUS
ទំព័រគំរូ:ICD9	Template:ICD9
ទំព័រគំរូ:CHL	Template:CHL
ទំព័រគំរូ:ASEAN	Template:ASEAN
ទំព័រគំរូ:Campaign	Template:Campagna
ទំព័រគំរូ:Cc-by-sa-3.0,2.5,2.0,1.0	Template:Cc-by-sa-3.0,2.5,2.0,1.0
ទំព័រគំរូ:Centralized discussion	Wikipedia:Wikipediano/Discussioni
ទំព័រគំរូ:Central banks	Template:Banche centrali
ទំព័រគំរូ:ទិន្នន័យ​នៃប្រទេសស៊ីរី	Template:SYR
ទំព័រគំរូ:OctoberCalendar	Template:Ottobre
ទំព័រគំរូ:ENG	Template:ENG
ទំព័រគំរូ:User la-2	Template:Utente la-2
ទំព័រគំរូ:User ru-1	Template:Utente ru-1
ទំព័រគំរូ:User zh-1	Template:Utente zh-1
ទំព័រគំរូ:User zh-2	Template:Utente zh-2
ទំព័រគំរូ:User zh-3	Template:Utente zh-3
ចំណាត់ថ្នាក់ក្រុម:រូបវិទូ	Categoria:Fisici per nazionalità
ចំណាត់ថ្នាក់ក្រុម:គមនាគមន៍នៅប្រទេសជប៉ុន	Categoria:Trasporti in Giappone
ចំណាត់ថ្នាក់ក្រុម:ប្រទេសហ្សំប៊ី	Categoria:Zambia
ចំណាត់ថ្នាក់ក្រុម:ការអប់រំនៅប្រទេសជប៉ុន	Categoria:Istruzione in Giappone
ចំណាត់ថ្នាក់ក្រុម:User ja-0	Categoria:Utenti ja-0
ចំណាត់ថ្នាក់ក្រុម:User nl	Categoria:Utenti nl
ទំព័រគំរូ:Unbulleted list	Template:Lista
ចំណាត់ថ្នាក់ក្រុម:User zh-1	Categoria:Utenti zh-1
ចំណាត់ថ្នាក់ក្រុម:User zh-3	Categoria:Utenti zh-3
ចំណាត់ថ្នាក់ក្រុម:User zh-2	Categoria:Utenti zh-2
ចំណាត់ថ្នាក់ក្រុម:មេកានិច	Categoria:Meccanica
ចំណាត់ថ្នាក់ក្រុម:រូបវិទូអាល្លឺម៉ង់	Categoria:Fisici tedeschi
ចំណាត់ថ្នាក់ក្រុម:រូបវិទូអ៊ីតាលី	Categoria:Fisici italiani
ចំណាត់ថ្នាក់ក្រុម:រូបវិទូបារាំង	Categoria:Fisici francesi
ចំណាត់ថ្នាក់ក្រុម:សេវាសាធារណៈ	Categoria:Servizi pubblici
ទំព័រគំរូ:Tnavbar-header	Template:Tnavbar-header
ចំណាត់ថ្នាក់ក្រុម:ព្រឹត្តិការណ៍កីឡាចំរុះ	Categoria:Manifestazioni multisportive
ចំណាត់ថ្នាក់ក្រុម:គណិតវិទូអាល្លឺម៉ង់	Categoria:Matematici tedeschi
ចំណាត់ថ្នាក់ក្រុម:ចំនួនគត់រឺឡាទីប	Categoria:Numeri interi
ចំណាត់ថ្នាក់ក្រុម:ត្រីកោណមាត្រ	Categoria:Trigonometria
ចំណាត់ថ្នាក់ក្រុម:ទ្រឹស្តីបទ	Categoria:Teoremi
ចំណាត់ថ្នាក់ក្រុម:អាកាសយានដ្ឋាន	Categoria:Aeroporti
ចំណាត់ថ្នាក់ក្រុម:រូបវិទូអាមេរិក	Categoria:Fisici statunitensi
ចំណាត់ថ្នាក់ក្រុម:អ្នកនិពន្ធល្បី	Categoria:Scrittori cambogiani
ចំណាត់ថ្នាក់ក្រុម:រង្វាន់ណូបែល	Categoria:Premio Nobel
ចំណាត់ថ្នាក់ក្រុម:ប្រទេសកម្ពុជា	Categoria:Cambogia
ចំណាត់ថ្នាក់ក្រុម:អ្នកនយោបាយប៉ាគីស្ថាន	Categoria:Politici pakistani
ទំព័រគំរូ:Lang-hy	Template:Armeno
ចំណាត់ថ្នាក់ក្រុម:អ្នកនយោបាយខ្មែរ	Categoria:Politici cambogiani
ចំណាត់ថ្នាក់ក្រុម:អ្នករុករកជនជាតិបារាំង	Categoria:Esploratori francesi
ចំណាត់ថ្នាក់ក្រុម:ស្រីលង្កា	Categoria:Sri Lanka
ចំណាត់ថ្នាក់ក្រុម:ទំព័រគំរូឈ្មោះភាសា	Categoria:Template testo straniero
ចំណាត់ថ្នាក់ក្រុម:អុនសេន	Categoria:Terme
ចំណាត់ថ្នាក់ក្រុម:ពហុធា	Categoria:Polinomi
ចំណាត់ថ្នាក់ក្រុម:អនុគមន៍	Categoria:Funzioni matematiche
ចំណាត់ថ្នាក់ក្រុម:ភាសាជប៉ុន	Categoria:Lingua giapponese
ចំណាត់ថ្នាក់ក្រុម:ចតុកោណ	Categoria:Quadrilateri
ចំណាត់ថ្នាក់ក្រុម:ត្រីកោណ	Categoria:Triangoli
ចំណាត់ថ្នាក់ក្រុម:សំភារៈ​សំណង់	Categoria:Materiali edilizi
ចំណាត់ថ្នាក់ក្រុម:សមីការ	Categoria:Equazioni
ចំណាត់ថ្នាក់ក្រុម:ស្ពាននៅប្រទេសជប៉ុន	Categoria:Ponti del Giappone
ចំណាត់ថ្នាក់ក្រុម:សិទ្ធិ	Categoria:Diritti
ចំណាត់ថ្នាក់ក្រុម:វិភាគគណិតវិទ្យា	Categoria:Analisi matematica
ចំណាត់ថ្នាក់ក្រុម:វិសមភាព	Categoria:Disuguaglianze
ចំណាត់ថ្នាក់ក្រុម:ឧទ្យានជាតិ	Categoria:Parchi nazionali
ចំណាត់ថ្នាក់ក្រុម:មីក្រូសេដ្ឋកិច្ច	Categoria:Microeconomia
ចំណាត់ថ្នាក់ក្រុម:HTML	Categoria:HTML
ចំណាត់ថ្នាក់ក្រុម:អាស៊ីហ្គេម	Categoria:Giochi asiatici
ចំណាត់ថ្នាក់ក្រុម:អេឡិចត្រូស្តាទិច	Categoria:Elettrostatica
ចំណាត់ថ្នាក់ក្រុម:អាកាសចរណ៍	Categoria:Trasporti
ចំណាត់ថ្នាក់ក្រុម:គណិតវិទ្យាថ្នាក់ដំបូង	Categoria:Matematica di base
ចំណាត់ថ្នាក់ក្រុម:ទ្រឹស្តីបទលេខ	Categoria:Teoria dei numeri
ទំព័រគំរូ:ប្រអប់ព័ត៌មាន ភាសា	Template:Lingua
ទំព័រគំរូ:Statistics	Template:Statistica
ចំណាត់ថ្នាក់ក្រុម:ភាសាអ៊ីតាលី	Categoria:Lingua italiana
ចំណាត់ថ្នាក់ក្រុម:ភាសាអេស្ប៉ាញ	Categoria:Lingua spagnola
ចំណាត់ថ្នាក់ក្រុម:រថក្រោះ	Categoria:Carri armati
ចំណាត់ថ្នាក់ក្រុម:កោះរបស់ឥណ្ឌូនេស៊ី	Categoria:Isole dell'Indonesia
ទំព័រគំរូ:Update after	Template:Da aggiornare
ទំព័រគំរូ:WPBannerMeta	Template:Monitoraggio
ខេត្តលង់ហោរ	Provincia di Vinh Long
ចំណាត់ថ្នាក់ក្រុម:ភ្នំពេញ	Categoria:Phnom Penh
ចំណាត់ថ្នាក់ក្រុម:ទំព័រគំរូសំរាប់ទង់ជាតិ	Categoria:Template bandierine nazionali
ចំណាត់ថ្នាក់ក្រុម:ឧទ្យានជាតិនៃព្រះរាជាណាចក្រកម្ពុជា	Categoria:Parchi nazionali della Cambogia
ទំព័រគំរូ:Split	Template:D
ទំព័រគំរូ:រូបវិទ្យា	Template:Sottocampi della fisica
ចំណាត់ថ្នាក់ក្រុម:ធរណីមាត្រអ៊ីពែបូលីក	Categoria:Geometria iperbolica
វិគីភីឌា:ឯកសារកម្មទំព័រគំរូ	Aiuto:Manuali dei template
ទំព័រគំរូ:CompactTOC8	Template:Indice
ទំព័រគំរូ:File title	Template:File title
ទំព័រគំរូ:JD	Template:Giorno giuliano
ទំព័រគំរូ:CURRENTMINUTE	Template:CURRENTMINUTE
ទំព័រគំរូ:Substituted	Template:Template non incluso
ទំព័រគំរូ:ទិន្នន័យ​នៃប្រទេសអ៊ូបេគីស្ថាន	Template:UZB
ទំព័រគំរូ:Question	Template:Domanda
ស៊ូ យ៉ាទី	Sou Yaty
បញ្ជីរាយនាម ជ័យលាភីរង្វាន់ណូបែល ផ្នែកគីមីវិទ្យា	Vincitori del premio Nobel per la chimica
ទំព័រគំរូ:ខេត្ត-រាជធានីកម្ពុជា	Template:Province della Cambogia
ទំព័រគំរូ:Pad	Template:Pad
ទំព័រគំរូ:Connected contributor	Template:Voce su un wikipediano
ទំព័រគំរូ:Flag	Template:Bandiera
ទំព័រគំរូ:Lang-pl	Template:Polacco
ទំព័រគំរូ:Str right	Template:Str right
ទំព័រគំរូ:Diff	Template:Diff
ទំព័រគំរូ:ប្រវត្តិសាស្ត្រវៀតណាម	Template:Storia del Vietnam
ចំណាត់ថ្នាក់ក្រុម:Protection templates	Categoria:Template di blocco pagine
ចំណាត់ថ្នាក់ក្រុម:ភាសាអង់គ្លេស	Categoria:Lingua inglese
ទំព័រគំរូ:FOSS	Template:FOSS
ទំព័រគំរូ:OCA	Template:COA
ទំព័រគំរូ:G8	Template:G8
ទំព័រគំរូ:Countries and regions of the Caucasus	Template:Stati e regioni del Caucaso
ទំព័រគំរូ:Technology	Template:Tecnologia
ទំព័រគំរូ:User zh-min-nan-2	Template:Utente zh-min-nan-2
ទំព័រគំរូ:PDB	Template:PDB
ទំព័រគំរូ:Nav book tool	Template:Navigazione libri
ទំព័រគំរូ:Km icon	Template:Km
ទំព័រគំរូ:AprilCalendar	Template:Aprile
ទំព័រគំរូ:JuneCalendar	Template:Giugno
ទំព័រគំរូ:MarchCalendar	Template:Marzo
ទំព័រគំរូ:ISO 3166	Template:ISO 3166
ចំណាត់ថ្នាក់ក្រុម:ពិជគណិត	Categoria:Algebra
ចំណាត់ថ្នាក់ក្រុម:មុំ	Categoria:Angolo
ចំណាត់ថ្នាក់ក្រុម:នព្វន្ធ	Categoria:Aritmetica
ចំណាត់ថ្នាក់ក្រុម:ស្ពាននៅអាស៊ី	Categoria:Ponti dell'Asia
ចំណាត់ថ្នាក់ក្រុម:អត្ថបទខ្លីមិនពេញលេញ អំពីព្រះពុទ្ធសាសនា	Categoria:Stub - buddhismo
ទំព័រគំរូ:Multicol	Template:Colonne
ចំណាត់ថ្នាក់ក្រុម:អេឡិចត្រូម៉ាញ៉េទិច	Categoria:Elettromagnetismo
វិគីភីឌា:វិគីគម្រោងប្រវត្តិសាស្ត្រ	Progetto:Storia
វិគីភីឌា:WikiProject Education	Progetto:Istruzione
ចំណាត់ថ្នាក់ក្រុម:បណ្ណាល័យ	Categoria:Biblioteche
ចំណាត់ថ្នាក់ក្រុម:មេរថក្រោះសមរភូមិ	Categoria:Carri armati da combattimento
ជំនួយ:Books/Frequently Asked Questions	Aiuto:Libri/FAQ
ជំនួយ:Books/for experts	Aiuto:Libri/per esperti
ជំនួយ:អសង្ស័យកម្ម	Aiuto:Disambiguazione
វិគីភីឌា:Link color	Aiuto:Colori dei link
ទំព័រគំរូ:ទិន្នន័យ​នៃប្រទេសម៉ុងហ្គោល	Template:MNG
ចំណាត់ថ្នាក់ក្រុម:ចំនួនកុំផ្លិច	Categoria:Numeri complessi
ចំណាត់ថ្នាក់ក្រុម:គ្រោង​វិភាគ	Categoria:Analisi strutturale
ចំណាត់ថ្នាក់ក្រុម:ទំព័រគំរូTOC	Categoria:Template indice
ទំព័រគំរូ:Image label begin	Template:Etichetta immagine inizio
ទំព័រគំរូ:Bg icon	Template:Bg
ចំណាត់ថ្នាក់ក្រុម:កងកម្លាំងអាកាស	Categoria:Forze aeree
ចំណាត់ថ្នាក់ក្រុម:សាកលវិទ្យាល័យនៅប្រទេសជប៉ុន	Categoria:Università in Giappone
ចំណាត់ថ្នាក់ក្រុម:User es-0	Categoria:Utenti es-0
ចំណាត់ថ្នាក់ក្រុម:វប្បធម៌ខ្មែរ	Categoria:Cultura della Cambogia
ចំណាត់ថ្នាក់ក្រុម:User en-1	Categoria:Utenti en-1
ចំណាត់ថ្នាក់ក្រុម:User de-1	Categoria:Utenti de-1
ចំណាត់ថ្នាក់ក្រុម:Wikipedia protected templates	Categoria:Template protetti
ទំព័រគំរូ:Chaturanga diagram	Template:Diagramma chaturanga
ទំព័រគំរូ:ែដលកំពុងរឺកចំេរីន	Template:WIP open
ទំព័រគំរូ:Not English	Template:T
ទំព័រគំរូ:December calendar	Template:Dicembre
ទំព័រគំរូ:JulyCalendar	Template:Luglio
វិគីភីឌា:WikiProject Council/Directory	Portale:Progetti
វិគីភីឌា:Tutorial/Keep in mind	Aiuto:Tutorial/Linee guida
ទំព័រគំរូ:Frac	Template:Frazione
ទំព័រគំរូ:Start date	Template:Start date
វិគីភីឌា:Contributing to Wikipedia	Wikipedia:Aiuta Wikipedia
ចំណាត់ថ្នាក់ក្រុម:ការធ្វើសេចក្ដីរាយការណ៏ពត៌មាន	Report informativo
ទំព័រគំរូ:User zh-min-nan-3	Template:Utente zh-min-nan-3
ទំព័រគំរូ:ប្រវត្តិសាស្ត្រភូមា	Template:Storia della Birmania
ទំព័រគំរូ:Herbs & spices	Template:Aromi e spezie
ទំព័រគំរូ:ប្រវត្តិសាស្ត្រខ្មែរ	Template:Storia della Cambogia
វិគីភីឌា:អំពី ប្រអប់ខ្សាច់	Aiuto:Pagina delle prove
វិគីភីឌា:Project namespace	Wikipedia:Pagine di servizio
វិគីភីឌា:Service awards	Wikipedia:Scherzi e STUBidaggini/Barnstar al merito wikipediano
វិគីភីឌា:Hatnotes	Wikipedia:Voci correlate
ទំព័រគំរូ:Infobox file format	Template:Formato file
ទំព័រគំរូ:ក្រុមជនជាតិនៅវៀតណាម	Template:Gruppi etnici del Vietnam
ទំព័រគំរូ:Db-g12	Template:Cancelcopy
វិគីភីឌា:Birthday Committee	Wikipedia:Wikipediani/Per giorno di nascita
វិគីភីឌា:WikiProject Buddhism	Progetto:Buddhismo
ទំព័រគំរូ:វីគីភីឌា-សៀវភៅ	Template:Wikilibro
ទំព័រគំរូ:Campaignbox World War II	Template:CampagnaBox Seconda guerra mondiale
វិគីភីឌា:WikiProject Council	Progetto:Coordinamento/Progetti
ទំព័រគំរូ:The Sun	Template:Sole
ទំព័រគំរូ:Mammals	Template:Mammiferi
វិគីភីឌា:Manual of Style (ប្រអប់ព័ត៌មាន)	Wikipedia:Template sinottici
ទំព័រគំរូ:Efn	Template:Efn
វិគីភីឌា:Babel/km-0	Wikipedia:Babel/It-0
រូបភាពដែលបាត់បង់	The Missing Picture
ទំព័រគំរូ:Editnotice pagename	Template:Editnotice pagename
ជំនួយ:ការប្តូរទីតាំងទំព័រ	Aiuto:Redirect
ទំព័រគំរូ:Subatomic particle/list	Template:Particella subatomica/lista
អាកាសចរណ៍ឡាវ ជើងហោះហើរ លេខ៣០១	Volo Lao Airlines 301
ព្យុះហៃយ៉ាន	Tifone Haiyan
ពិសេស:បំលាស់ប្ដូរថ្មីៗ	Speciale:UltimeModifiche
Module:Citation/CS1	Modulo:Citazione
Module:Coordinates	Modulo:Coord
Module:Navbox	Modulo:Navbox
Call of Duty: Advanced Warfare	Call of Duty: Advanced Warfare
បញ្ជីនៃទង់ជាតិអង្គភាពរដ្ឋបាលរាជវង្សង្វៀនរបស់	Bandiere delle unità amministrative della dinastia Nguyen
