Naakaii Łizhiní Bikéyah	Africa
Binaʼadaałtzózí Dinéʼiʼ Bikéyah	Giappone
Bitsiighaʼ Łichííʼí Bikéyah	Irlanda
Hángewii	Ungheria
Dibé Diníí Bikéyah	Spagna
Wááshindoon Bikéyah Ałhidadiidzooígíí	Stati Uniti d'America
Bélgii Bikéyah	Belgio
Látsębooʼ	Lussemburgo
Yágháhookáán	Universo
Nahasdzáán	Terra
Nahoditsʼǫʼłání	Finlandia
Déinish Dineʼé Bikéyah	Danimarca
Póolish Dineʼé Bikéyah	Polonia
Łitʼoowę́ęya	Lituania
Ídelii	Italia
Swis Bikéyah	Svizzera
Óóswiya	Austria
Gwíík Dineʼé Bikéyah	Grecia
Tʼóok Bikéyah	Turchia
Béésh Bichʼahníí Bikéyah	Europa
(*@@@u0026asia")	Asia
Shádiʼááhjí kéyah yistinígíí	Antartide
Kéyah Wóyahgo Siʼánígíí	Paesi Bassi
Béésh bee akʼeʼelchíhí tʼáá bí nitsékeesígíí	Computer
Hastiin alą́ąjįʼ dahsidáhígíí Barack Obama	Barack Obama
Táłtłʼááh Chʼosh Bitooh (Kéyah Dah Siʼánígíí)	Uruguay
Bilasáana	Mela
Méhigo	Messico
Akééháshį́į́h Hahoodzo	California
Máaz	Marte (astronomia)
Kénya	Kenya
Iithiyópya	Etiopia
Gáana	Ghana
Náshdóítsoh bitsiijįʼ daditłʼooígíí	Panthera leo
Dáághahii Dinéʼiʼ Bikéyah	Francia
Łééchąąʼí	Canis lupus familiaris
Tótaʼ Dinéʼiʼ Bikéyah	Regno Unito
Mósí	Felis silvestris catus
Dáághahii bizaad	Lingua francese
Łóóʼ	Pesce
Bwazííl	Brasile
Biʼééʼ Łichííʼí Bikéyah	Russia
Łóóʼtsoh dóó Tééh hóyáanii	Cetacea
Élábéemah Hahoodzo	Alabama
Béésh Bichʼahii Bikéyah	Germania
Bééshbichʼahii bizaad	Lingua tedesca
Tin Bikéyah	Islanda
Ééstii Bikéyah	Estonia
Séetin	Saturno (astronomia)
Didzéchííʼ	Ciliegia
Chidí naatʼaʼí	Aeroplano
Hastiin alą́ąjįʼ dahsidáhígíí George W. Bush	George W. Bush
Létbiiya	Lettonia
Yóókwein	Ucraina
Chek Bikéyah	Repubblica Ceca
Słóbaʼ Bikéyah	Slovacchia
Słobíín Bikéyah	Slovenia
Wooméiniya	Romania
Bálgaa Bikéyah	Bulgaria
Dziłigaii Bikéyah	Albania
Haʼaʼaahjí Hakʼaz Dineʼé Bikéyah	Groenlandia
Kwóóʼad Bikéyah	Croazia
Bosna dóó Hetsog Bikéyah	Bosnia ed Erzegovina
Azééwii Bikéyah	Azerbaigian
Andówa	Andorra
Béésh Łichíiʼii Bikéyah	Cipro
Jóojah (Kéyah)	Georgia
Kʼazah Bikéyah	Kazakistan
Dziłizhin Bikéyah	Montenegro
Bádikin Sídii	Città del Vaticano
San Mawínoo Bikéyah	San Marino
Kyóoba	Cuba
Hashkʼaan Bikéyah	Barbados
Indoníízha	Indonesia
Tʼóok bizaad	Lingua turca
Kéyah Naakai Łizhinii Bikéyah Shádiʼááhjí Siʼánígíí	Sudafrica
Aljííya	Algeria
Ózbeʼ Bikéyah	Uzbekistan
Tó	Acqua
Níłchʼi naalkidí	Televisione
Chíilii	Cile
Doodaatsaahii (Jíísas)	Gesù
Mókiwii	Mercurio (astronomia)
Ákáʼátʼįįł (béésh ntsékeesígíí álʼíní)	Apple
Biinis	Venere (astronomia)
Jíbitoo	Giove (astronomia)
Yoowéinis	Urano (astronomia)
Néʼtoon	Nettuno (astronomia)
Sį́ʼgaboo	Singapore
Tłóotoo	Plutone (astronomia)
Łííhtensain	Liechtenstein
Dágháilchįįh	Adolf Hitler
Naaltsoos biniiʼ	Facebook
Naaki góneʼ yéigo daʼahijoogą́ą́ʼ	Seconda guerra mondiale
Ałhíʼayiiltááh	Matematica
Aooméénii Bikéyah	Armenia
Ooljééʼ	Luna
Nahatʼeʼiitsoh Bikéyah	Australia
Béésh Łigaii Bikéyah	Argentina
Kolíya Bikéyah Náhookǫsjí Siʼánígíí	Corea del Nord
Naayééʼ	Dinosauria
Bilasáana bitseeʼ nineezígíí	Pyrus
Naturalis Historia of Pliny the Elder	Naturalis historia
Encyclopædia Britannica	Enciclopedia Britannica
Tó yaʼnidaʼaazgééd	Acquedotto
Chʼil łitsooí díkʼǫ́zhígíí	Citrus × limon
Hashkʼaan (łitsooígíí)	Banana
Sǫʼ	Stella
Jóhonaaʼéí	Sole
Háájiʼjin	Idrogeno
Níłchʼi Ászólí	Elio
Haʼaʼaahjí Tíímow	Timor Est
Séwes	Cerere (astronomia)
Haʼooméya	Haumea (astronomia)
Maakiimaakii	Makemake (astronomia)
Ééwis	Eris (astronomia)
Káábin	Carbonio
Níłchʼi Yáʼátʼéehii	Ossigeno
Hadoh dóó hakʼaz neiłkidígíí	Termometro
Níłchʼi Łitsxooí	Neon
Chihuahua Hahoodzo	Chihuahua (stato)
Soodin	Sodio
Béésh Łikoní	Magnesio
Béésh Ászólí	Alluminio
Tó Wónaanídę́ę́ʼ Bitsįʼ Yishtłizhii Bikéyah	India
Tʼoobááloo	Tuvalu
Béésh (Fe)	Ferro
Tʼónga	Tonga
Łeetsoii	Zolfo
Samóa	Samoa
Sólomon Tó Bináhaazyínígíí	Isole Salomone
Banoʼáátʼoo	Vanuatu
Páápowa Bigíní Ániidí	Papua Nuova Guinea
Níłchʼi Dootłʼizhí	Argon
Eʼeʼaahjí Tónteel bikáaʼgi Kéyah Yázhí dah Ndaaʼeełgo Ałhidadiidzooígíí	Stati Federati di Micronesia
Káálsiiyin	Calcio (elemento chimico)
Dilyį́hí	Piombo
Kílíbas	Kiribati
Chʼah Diʼilii Bikéyah	Mongolia
Fííjii	Figi
Béésh doo Ńdiniichxíihii	Titanio
Táłkááʼ Bighan Dineʼé Bikéyah	Venezuela
Méíin Hahoodzo	Maine
Łį́į́ʼ	Equus caballus
Naaldeehii	Animalia
Sówinam	Suriname
Kéyah Nahasdzáán Ałníiʼgi Siʼánígíí	Ecuador
Kolámbiya	Colombia
Béésh Łibáhí	Cobalto
Bolíbiya	Bolivia
Béésh Łichíiʼii	Rame
Niihémpshoo Hahoodzo	New Hampshire
Chʼosh doo yitʼíinii dláádí dóó Ábishjaaʼ	Fungi
Jaméíkʼa	Giamaica
Méésíchóoshish Hahoodzo	Massachusetts
Kanédikiʼ Hahoodzo	Connecticut
Naaʼahóóhai	Gallus gallus domesticus
Antíígwa dóó Hashkʼaan Bikéyah Yázhí	Antigua e Barbuda
Kéyah Ałkéé Nitį́įgo Dah Ndaaʼeełí	Hawaii
Damóo Bikéyah	Dominica
Domingo Bikéyah	Repubblica Dominicana
Bisóodi	Sus scrofa domesticus
Héítii	Haiti
Iiwą́ą́	Iran
Iiwááʼ	Iraq
Hakʼaz Dineʼé Bikéyah Hahoodzo	Alaska
Ízrel Bikéyah	Israele
Shádiʼááhjí Ásáí Bikéyah	Yemen
Jóoʼdan	Giordania
Gah Bikeeʼ Taahíʼahí	Florida
Kíígiz Bikéyah	Kirghizistan
Hoozdo Hahoodzo	Arizona
Kóóweiʼ	Kuwait
Lááʼos	Laos
Łíbanoo	Libano
Óogin Hahoodzo	Oregon
Naakaii Dootłʼizhí Bikéyah Yázhí (Tó Bináhaazyínígíí)	Maldive
Kéyah dah siʼánígíí	America
Áshįįh Biiʼtó Hahoodzo	Utah
Béégashii	Bos taurus
Maléízha	Malesia
Dziłgaiitsoh Honeezkʼazii Bikéyah	Nepal
Omą́ą́	Oman
Eʼeʼaahjí Naakaii Dootłʼizhí Bikéyah	Pakistan
Kʼatár	Qatar
Ásáí Bikéyah Saʼoodí	Arabia Saudita
Swii Lankʼa	Sri Lanka
Sííwiya	Siria
Tʼajiʼ Bikéyah	Tagikistan
Tʼáí Bikéyah	Thailandia
Kǫʼ naʼałbąąsii diné bee nágéhéʼ	Treno
Tʼóokmen Bikéyah	Turkmenistan
Ásáí Bikéyah Yázhí Ałhidadiidzooígíí	Emirati Arabi Uniti
Biʼednam	Vietnam
Kolíya Bikéyah Shádiʼááhjí Siʼánígíí	Corea del Sud
Óola	Oro
Naʼałkaahí	Scienziato
Bangla Bikéyah	Bangladesh
Angóola	Angola
Iiʼniʼ Tłʼiishtsoh Bikéyah	Bhutan
Bwoonéí	Brunei
Tʼanzanííya	Tanzania
Béésh Tózháanii	Mercurio (elemento chimico)
Kéyah Dańlíinii	Filippine
Naakaii Łizhinii Bikéyah Beʼałnííʼ	Repubblica Centrafricana
Hastiin Albert Einstein	Albert Einstein
Tʼóogo	Togo
Hooghan Tsé Bee Ádaalyaaí Bikéyah	Zimbabwe
Shádiʼááhjí Soodą́ą	Sudan del Sud
Tswana Dineʼé Bikéyah	Botswana
Wóndii Dineʼé Bikéyah	Burundi
Ooljééʼ Bikéyah Yázhí	Comore
Kéyah Káango Náhookǫsjí Siʼánígíí	Repubblica del Congo
Kéyah Káango Shádiʼááhjí Siʼánígíí	Repubblica Democratica del Congo
Jibótii	Gibuti
Gíní Nahasdzáán Ałníiʼgi Siʼánígíí	Guinea Equatoriale
Gabǫ́ǫ́ (Kéyah)	Gabon
Géémbiya	Gambia
Gíní	Guinea
Gíní Bisó	Guinea-Bissau
Chį́į́h Yee Adilohii Bideeʼ Tónteel Bibąąh	Costa d'Avorio
Táłtłʼááh Chʼosh Daadánígíí Bitooh (Łizhinii Bikéyahdi)	Camerun
Tónteel Bibąąh Dootłʼizhí	Capo Verde
Sotho Dineʼé Bikéyah	Lesotho
Łíbya	Libia
Madaʼgéésgáá	Madagascar
Malááwii	Malawi
Moowitéínya	Mauritania
Moroko	Marocco
Namííbya	Namibia
Yogénda	Uganda
Wánda Dineʼé Bikéyah	Ruanda
Seishel	Seychelles
Náshdóítsoh Bitsiijįʼ Daditłʼooʼígíí Bidził	Sierra Leone
Soomáálii Bikéyah	Somalia
Soodą́ą	Sudan
Swáazi Dineʼé Bikéyah	Swaziland
Nahasdzáán Bikáaʼgi Kéyah Naaznilgo Ałhidadiidzooígíí	Organizzazione delle Nazioni Unite
Nidaashchʼąąʼígíí	Colore
Béésh Łigaii	Argento
Béésh Dildǫʼí	Stagno (elemento chimico)
Łéétsoh	Uranio
Hastiin alą́ąjįʼ dahsidáhígíí Bill Clinton	Bill Clinton
Míshigin Hahoodzo	Michigan
Tó Nitsaa Nílį́bąąh Hahoodzo	Illinois
Náhookǫsjí Dzígaii	Dakota del Nord
Ałnííʼjí Dzígaii	Dakota del Sud
Ayání Naakaii Hahoodzo	Montana
Tóʼííbézhí	Wyoming
Nímasii Kʼidadilyéhé	Idaho
Ahééhałtį́į́h Hahoodzo	Washington (stato)
Naʼazhǫǫsh Hahoodzo	Nevada
Kayíbíyinsíí (tónteel)	Mare Caraibico
Dibé Nitsaa Hahoodzo	Colorado
Naakaii bizaad	Lingua spagnola
Naʼashjéʼii	Araneae
Chʼosh bijáád tseebíhígíí	Arachnida
Chʼosh bideeʼ ádaadinígíí	Chelicerata
Chʼosh bijáád dahólónígíí	Arthropoda
Béeso	Denaro
Bijíniyah Hahoodzo	Virginia
Eʼeʼaahjí Bijiniyah Hahoodzo	Virginia Occidentale
Kin Yótʼááh Deezʼá Hahoodzo	New York (Stato)
Wóód Áalin Hahoodzo	Rhode Island
Chʼosh bijáád hastání	Insecta
Méelin Hahoodzo	Maryland
Déláwee Hahoodzo	Delaware
Oohááyoo Hahoodzo	Ohio
Pénsówéíniyah Hahoodzo	Pennsylvania
Niijéízii Hahoodzo	New Jersey
Índíʼyéenah Hahoodzo	Indiana
Chidí	Autovettura
Jóojah Hahoodzo	Georgia (Stati Uniti d'America)
Akałii Bikéyah	Texas
Náhookǫsjí Kééláanah Hahoodzo	Carolina del Nord
Shádiʼááhjí Kééláanah Hahoodzo	Carolina del Sud
Méhigoʼ sídii	Città del Messico
Bilasáana diwozhí	Ananas comosus
Mísísípii Hahoodzo	Mississippi
Ténésii Hahoodzo	Tennessee
Yootó Hahoodzo	Nuovo Messico
Mínisóodah Hahoodzo	Minnesota
Wiskaansin Hahoodzo	Wisconsin
Haʼaʼaahjí Dzígaii	Iowa
Nabeeskah Hahoodzo	Nebraska
Shádiʼááhjí Dzígaii	Kansas
Tó Dzígaii Nílį́	Missouri
Tónteel Chʼínílį́	Louisiana
Kentákii Hahoodzo	Kentucky
Dził Biiʼ Dzígaii	Arkansas
Halgai Hóteel Hahoodzo	Oklahoma
Ho Chi Min Sídii	Ho Chi Minh (città)
Bilagáana bizaad	Lingua inglese
Náhookǫsjí Hakʼaz Dineʼé Bikéyah	Nunavut
1901 – 1950	1902
Tłʼiish	Serpentes
1951 – 2000	1979
Pope Benedict XVI	Papa Benedetto XVI
Maʼii Ashkii	Geronimo
Tsin naaʼeeł táłtłʼááh naagháhígíí	Sottomarino
Tahoniigááh	Influenza
Tłʼízí	Capra hircus
Kǫʼ	Fuoco
Tʼááłáhági átʼéego:Templates	Categoria:Template
Dloziłchííʼ	Sciurus vulgaris
Tʼááłáhági átʼéego:Bideeʼtsʼinígíí	Categoria:Bovidi
Tiníléítsoh	Varanus komodoensis
Chʼosh bijáád neeznánígíí	Decapoda
Aymara bizaad	Lingua aymara
Łeeyiʼ chʼoshtsoh binááʼ hólónígíí	Gymnophiona
Tʼááłáhági átʼéego:Dééł dóó Tóidoozohii	Categoria:Gruiformes
Médíwííyin Sii	Mar Mediterraneo
Jóojah (Ałtsʼáʼáztiin)	Georgia (disambigua)
Tsídii	Aves
Kéłánii bikágí yilzhólígíí	Onychophora
Kéchwa bizaad	Lingue quechua
Ínsadoobíídiiya	Enciclopedia
Íiyisíí Naaltsoos	Pagina principale
Dziłgaiitsoh Honeezkʼazii	Himalaya
Tʼááłáhági átʼéego:Candidates for speedy deletion	Categoria:Cancellare subito
Chʼil ahwééh	Tè
Adijiłii	Erinaceinae
Kéyah Sahééwa Eʼeʼaahjí Siʼánígíí	Sahara Occidentale
1801 – 1850	1815
Łį́į́ʼ Bideeʼłáaʼii	Unicorno
Hastiin Hernán Cortés	Hernán Cortés
Tsʼíʼii daʼaneezí	Culicidae
Dibé	Ovis aries
Łóóʼ hashkéhé	Selachimorpha
Ghą́ą́ʼaskʼidii	Camelus
Bidił Daazdoígíí dóó Daʼałtʼoʼígíí	Mammalia
Mágí dóó Mágí Ndahalinígíí	Primates
(*wálá-)	Formicidae
Tsísʼná	Anthophila
Sęęschʼil	Brassica oleracea var. botrytis
Ayęęzhii yiltʼąąʼí	Solanum melongena
Naalʼeełí	Anatidae
Yas	Neve
Jádí dághaaʼígíí	Connochaetes
1851 – 1900	1865
Biʼééʼ Łichííʼí bizaad	Lingua russa
1751 – 1800	1784
Bááh	Pane
Bee Hazʼą́ą Ił Chʼétʼaah	Dichiarazione universale dei diritti umani
Kéyah haʼdéísná	Terremoto
Tó nitéél nitságoʼ atságáá	Maremoto
Níyoltsoh	Tromba d'aria
Saad bee alʼį́į́hni	Sistema di scrittura
Tʼááłáhági átʼéego:Dáághahii	Categoria:Francia
Mąʼii łitsooí	Vulpes vulpes
Naaltéʼ	Schiavismo
Ahwééh	Caffè
Abeʼ	Latte
Dził	Montagna
Doo Nidahałtingóó	Deserto
Cryptographic	Crittografia
Guadalajara	Guadalajara (Messico)
Tsídii naʼałkʼaiʼí	Spheniscidae
Kolíya Dineʼé bizaad	Lingua coreana
Gah	Coniglio
Tó niteel	Oceano
Hodíłchʼil Níłtsánígíí	Foresta pluviale
HiTSʼezh	IPod
Hazéí	Sciuridae
Hazéí naatʼáʼii	Scoiattolo volante
Ééʼ néíshoodí	Chiesa cattolica
Kwį́į́n Elizabeth II	Elisabetta II del Regno Unito
Hastiin alą́ąjįʼ dahsidáhígíí Ronald Reagan	Ronald Reagan
Hastiin Emperor Yongle	Yongle
Naʼashjéʼiitsoh	Lycosidae
Naaldlooshii dadichʼízhii	Reptilia
Tsin Deigházhígíí	Rodentia
Hasbídí	Columbidae
Tééh hóyáanii	Phocoenidae
Biyáázh Tsʼǫʼasánígíí (Táyiʼ dóó Niʼkáágóó Ndaakaaígíí)	Amphibia
Géeso	Formaggio
Chʼil naʼatłʼoʼii (chʼiyáán)	Uva
Tsísʼná bitłʼizh	Miele
Atsįʼ	Carne
Naʼashjéʼii tsiizisí	Pholcidae
Nímasii	Solanum tuberosum
Haʼałtsédii	Noce (botanica)
Wááshindoon bisiláołtsooí	United States Armed Forces
Naʼiiniʼ bá Hooghantsoh	World Trade Center
Wááshindoondi bee hazʼáanii ádeiłʼíní	Congresso degli Stati Uniti d'America
Tsin naaʼeeł	Nave
Nidaʼąnyéézh	Irrigazione
Naadą́ą́ʼ	Zea mays
Naʼashchʼąąʼ	Pittura
Wótáahgoo ałnaaʼáłtʼahiʼ	Astronauta
Azhish	Danza
Naʼashjéʼii nahachaʼígíí	Salticidae
Kéyah Daʼnaaznilígíí	Stati del mondo
Shash	Ursidae
Hastiin alą́ąjįʼ dahsidáhígíí John Adams	John Adams
Hastiin alą́ąjįʼ dahsidáhígíí Thomas Jefferson	Thomas Jefferson
Hastiin alą́ąjįʼ dahsidáhígíí Andrew Jackson	Andrew Jackson
Ńdíshchííʼ	Pinus
Tłʼoh naadą́ą́ʼ	Triticum
Naałniih yichʼą́ą́h naabaahígíí bąąh dahooʼaahgo	AIDS
Abeʼ bee neezmasí	Crespella
Jéíʼádįįh	Tubercolosi
Łóódtsoh	Vaiolo
Zelda bahaneʼ	The Legend of Zelda (serie)
Naakáí dinéʼiʼ biempire Méhigodi	Aztechi
Łéétsoh bee atsiniltłʼish álʼį́	Energia nucleare
Łéétsoh beeʼeldǫǫhtsoh beeʼalį́į́h	Arma nucleare
Chidí naaʼnaʼí beeʼeldǫǫh bikááʼ dah naaznilígíí	Carro armato
Dah woozh	Fragola
Jalisco Hahoodzo	Jalisco
Mágí bichʼiyąʼ	Cocos nucifera
Dzidzétsoh	Prunus persica
Chʼil łitsxooí	Citrus × sinensis
Chʼil dishooí	Kiwi (frutto)
Abeʼ yistiní	Gelato
Méhigo bizaad	Lingua nahuatl
Diné bizaad	Lingua navajo
Jeeʼiighááh	Dermaptera
Tenochtitlan	Tenochtitlán
Ásáí Bizaad	Lingua araba
Honeezílígi	Clima subtropicale
Atʼaʼ yiltʼąąʼí	Arecaceae
Niłchiis	Gulo gulo
Tsin yilátah ayání	Giraffa camelopardalis
Naalʼeełídaaʼí	Ornithorhynchus anatinus
Naʼashǫ́ʼii	Lacertilia
Béésh bee akʼeʼelchí áłtsisígíí	Personal computer
Wikiibíídiiya:Naaltsoos nizhónígo ádaalyaaígíí	Wikipedia:Vetrina
Bee álnééhí:Link FA	Template:Link V
Bimááʼ Hahoodzo	Vermont
Hoozdoh	Phoenix (Arizona)
Táłkááʼ tsʼin bíchį́į́hnézí	Gavialis gangeticus
Tsin naaʼeeł chidí naatʼaʼí bee nágéhéʼ	Portaerei
Tsídiitsoh	Struthio camelus
Kolíya bikéyah (Ałtsʼáʼáztiin)	Corea
Mąʼiitsoh	Canis lupus
Chʼídeeldlóohiitsoh	Balaeniceps rex
Hodíłchʼilgi dlǫ́ʼiitsoh	Paradoxurus hermaphroditus
Tóidoozohii bidaaʼ łichííʼígíí	Gallinula chloropus
Táłtłʼááh yilcháazhii	Porifera
Tónteel naʼashjéʼii	Pycnogonida
Séigoʼ bíláshgaanézí	Amblypygi
Naʼashjéʼii jáádnézí	Opiliones
Séigoʼchilí bitseeʼ ádinígíí	Pseudoscorpionida
Séigoʼ	Scorpiones
Zahalchíʼii	Solifugae
Hastiin Emperor Qianlong	Qianlong
Séigoʼ bitseeʼ áłtsʼózígíí	Uropygi
Yaaʼ doo yitʼíinii	Acarina
Hodíłchʼilgi naaʼahóóhai	Tinamidae
Télii	Equus asinus
Náshdóítsoh noodǫ́zígíí	Panthera tigris
Kʼíneeshbízhiinééz	Spaghetti
Chʼosh yoołgai bitsʼaʼígíí	Ostreidae
Azeeʼ hókániitsoh	Cirsium vulgare
Táłkáaʼgi Tsídii	Anseriformes
Tązhii dóó Naaʼahóóhai Ndahalinígíí	Galliformes
Naalʼeełii keelóól	Podicipedidae
Tsídii Deílʼésígíí	Ciconiiformes
Daʼałtʼoʼígíí Biyęęzhii Deiłchíhígíí	Monotremata
Adijiłii bíchį́į́hnézí	Tachyglossidae
Biyázhí neiyéhé	Didelphidae
Hazéítsʼósii	Tamias (zoologia)
Chidí bikʼah	Petrolio
Chéłchaaʼ	Coleoptera
Łį́į́ʼ ałchiní	Equus ferus przewalskii
Dlǫ́ʼii yił aheełtʼéhii noodǫ́zígíí	Mungos mungo
Naʼastsʼǫǫsíʼniiʼí	Peramelidae
Shash naʼazísí	Vombatidae
Nahatʼeʼiitsohchilí	Potoroidae
Náʼagéédí łichíiʼii	Chrysochloridae
Bįįh Danilínígíí	Cervidae
Tin	Ghiaccio
Tłʼohchin díchʼííʼí	Allium sativum
Taʼneeskʼání áłtsʼóózígíí	Cucumis sativus
Tłʼohchin (chʼil daadánígíí)	Allium cepa
Chʼil łichxíʼí	Solanum lycopersicum
Béésh Łichíiʼii Bikéyah Náhookǫsjígo Siʼanígíí	Cipro del Nord
Naʼazhǫǫsh Hátsoh	Las Vegas
Náshdóí dilwoʼí	Acinonyx jubatus
Tsékǫʼ	Carbone
Néʼéshjaaʼ	Strigiformes
Bíígháán Dahólónígíí	Vertebrata
Kʼishchííʼ	Betula
Ǫǫbǫʼii	Upupa epops
Náshdóí Ndahalinígíí	Felidae
Yádiłhił yiiyídíʼ nahosdzáán yináádáłiʼ	Stazione Spaziale Internazionale
Tó wónaanídę́ę́ʼ toohjįʼ noołnahii	Ardea cinerea
Hashkʼaan dijéʼé	Phoenix dactylifera
Wááshindoon (Ałtsʼáʼáztiin)	Washington (disambigua)
Bidił Daazdoígíí dóó Daʼalghałígíí	Carnivora
Chʼoshtsoh	Blattodea
Dlǫ́ʼii yázhí	Mustela nivalis
Tsʼíʼii dóó Tséʼédǫ́ʼii	Diptera
Biniiʼłigaii (néʼéshjaaʼ)	Tyto alba
Mąʼii Ndahalinígíí	Canidae
Bijáád Ádaadinígíí	Mollusca
Chʼosh łitsxooí dóó Chʼosh łichííʼí	Coccinellidae
Táłkááʼ naalzheehí	Pandion haliaetus
Bizaʼazis Dahólónígíí	Metatheria
Dlǫ́ʼiiłgaii	Mustela erminea
Naalʼeełí bitsiiʼ dootłʼizhí	Anas platyrhynchos
Sǫʼ łóóʼ	Asteroidea
Giníłbáhí	Accipiter gentilis
Tʼádootłʼizhii	Garrulus glandarius
Zhį́ʼii	Corvus corax
Táłkááʼ tsʼin Danilínígíí	Crocodylia
Chʼosh bikágí dantłʼizí	Crustacea
Dééł	Gruidae
Chʼosh bitsʼaʼígíí	Bivalvia
Łóóʼ ooshgę́ęzhii	Chondrichthyes
Tániilʼáí	Odonata
Wóláchííʼ yildeełí bikágí ntłʼizí	Manis
Gah Danilínígíí	Lagomorpha
Tsísʼnátsoh	Bombus
Hazéí yiltseeʼí	Achillea millefolium
Chʼosh bikǫʼí	Lampyridae
Zéédzísgaii	Phasianus colchicus
Dlǫ́ʼii Ndahalinígíí	Mustelidae
Tsin yiłkaałii	Picidae
Bideeʼtsʼinígíí	Bovidae
Dééł dóó Tóidoozohii Ndahalinígíí	Gruiformes
Gáagii dóó Joogii Ndahalinígíí	Corvidae
Chʼiltaatʼagii	Circus cyaneus
Tsin naaʼeeł diné bee nágéhéʼ	Traghetto
Gad	Juniperus
Jááłánii	Myriapoda
Biishchʼid Dahólónígíí	Eutheria
Chʼosh Deildeełii	Insectivora
Tó wónaanídę́ę́ʼ naalʼeełítsoh łibáhígíí	Anser anser
Tónteel dóó Tábąąhgi Tsídii	Charadriiformes
Ńdíshchíitah dlǫ́ʼii	Martes martes
Biyaatsʼiin Dahólónígíí	Gnathostomata
Tooh łéʼétsoh	Ondatra zibethicus
Chaatʼíní	Rumex acetosa
Łóóʼ hashkéhé dootłʼizhígíí	Prionace glauca
Wóʼatsʼǫǫsii Ádaatʼéhígíí	Rhynchota
Atsáłgaii	Buteo lagopus
Béégashiiʼilí	Bos grunniens
Tó wónaanídę́ę́ʼ dlǫ́ʼii	Mustela putorius
Tsxį́į́łnaalkʼįhii	Apodidae
Dziłditłʼoii Bił Hahoodzo	Contea di San Juan (Utah)
Hakʼaz naalʼeełí	Somateria mollissima
Naalʼeełítsoh bitsiiʼ halzhinígíí	Branta canadensis
Chʼó	Picea
Łóóʼtsoh łizhin dóó łigaígíí	Orcinus orca
Jáádtsʼósí	Recurvirostridae
Téél dzítsooii dóó Tsétah chʼosh	Carabidae
Naalʼeełítsoh diłhiłígíí	Branta bernicla
Tábąąh dlǫ́ʼii	Neovison vison
Dlǫ́ʼii bitéél halgaií	Martes foina
Tábąąstííntsoh łibáhígíí	Halichoerus grypus
Naakaii Łizhiní Bikéyahdi Hadahóólįįdígíí	Afrotheria
Diné Nááhódlóonii bizaad	Lingue athabaska
Łį́į́ʼ bitsísʼná	Oestridae
Tónteel tsídii	Laridae
Ałtį́į́ jikʼáshí (chʼil)	Equisetum
Hazaʼaleehtsoh (dííshjį́ ááłjiní)	Apium graveolens
Kʼaalógii dóó Iichʼąhii	Lepidoptera
Díłdánii yił aheełtʼéhii	Coturnix coturnix
Chʼałdą́ą́ʼ / Jádí nátʼoh (chʼil daadánígíí)	Asparagus officinalis
Tséʼédǫ́ʼii dootłʼizhí	Calliphoridae
Jaaʼabaní Danilínígíí	Chiroptera
Wóónałchídii	Elateridae
Tsídii bidaanézí	Ciconiidae
Dlǫ́ʼii	Mustela
Lókʼaaʼ	Phragmites australis
Tsídiiłbáhí	Passeridae
Biłʼeʼeliníʼ	Lievito chimico
Táłtłʼááh chʼoshchilí	Euphausiacea
Naalʼeełí binááʼ łitsooígíí	Bucephala clangula
Tábąąstíín	Lutra lutra
Jélii łóóʼ	Medusa (zoologia)
Náshdóíłgaii łikizhígíí	Panthera uncia
Tábąąstííntsoh Danilínígíí	Pinnipedia
Dlǫ́ǫ́ʼ	Cynomys
Náshdóí bijaałizhiní	Caracal caracal
Chʼóhojilyééh	Datura stramonium
Chʼah Diʼilii Bikéyahdę́ę́ʼ naalʼeełítsoh	Anser cygnoides
Tsídii yáłtiʼí	Psittaciformes
Tééh łį́į́ʼ	Zebra
Náshdóí łikizhígíí	Leopardus pardalis
Dííłdzid jeeshóóʼ	Neophron percnopterus
Tʼáadoo leʼé danílʼį́ bił hazʼą́	Museo
Shash łizhin dóó łigaígíí	Ailuropoda melanoleuca
Shash łigaígíí	Ursus maritimus
Gaantsʼosí	Crinoidea
Hastiin alą́ąjįʼ dahsidáhígíí Theodore Roosevelt	Theodore Roosevelt
Neeshchʼííłgai	Anacardium occidentale
Dilní bee Nidaʼanéhígíí	Strumento musicale
Dééłgai	Cygnus (zoologia)
Bikááʼ náʼoobałí	Elicottero
Dziʼizítsoh	Motocicletta
Tééhoołtsódii	Hippopotamus amphibius
Séí	Sabbia
Naakaii Łizhiní Bikéyahdę́ę́ʼ náshdóítsoh łikizhígíí	Panthera pardus
Déélgééd	Rhinocerotidae
Beeʼeldííl Dahsinil	Albuquerque
Hashkʼaan dootłʼizhí (babáayah)	Carica papaya
Chʼil łigaii (atʼééké bijish)	Brassica oleracea var. capitata
Náshdóítsoh	Puma concolor
Ásáí dinéʼiʼ	Arabi
Deeteel	Alces alces
Shádiʼááhdę́ę́ʼ náshdóítsoh łikizhígíí	Panthera onca
Lókʼaatsoh	Bambuseae
Káango (Ałtsʼáʼáztiin)	Congo
Kʼaiʼ	Salix
Shash bizaʼazis hólóní	Phascolarctos cinereus
Náshdóí kʼos bee naashchʼąąʼígíí	Neofelis nebulosa
Shashtsoh	Ursus arctos
Łéʼétsoh	Rattus
Akʼáán	Farina
Mágítsoh	Gorilla
Bitsįʼ yishtłizhii	Nativi americani
Chʼil akʼahí	Persea americana
Neeshchʼííłbáhí	Arachis hypogaea
Dzidzétsoh díkʼǫ́ǫzhii	Prunus armeniaca
Naʼashǫ́ʼii łahgo ánééhé	Chamaeleonidae
Yootó	Santa Fe (Nuovo Messico)
Łééchąąłgaii	Greyhound
Nahatʼeʼiitsoh Bikéyahdę́ę́ʼ łééchąąʼí ałchiní	Canis lupus dingo
Chʼééhjiyáán	Citrullus lanatus
Teide	Teide
Naʼastsʼǫǫsí	Mus (genere)
Hakʼaz bįįh	Rangifer tarandus
Chʼosh doo yitʼínii	Microrganismo
Táshchozhii	Hirundinidae
Neeshchʼííʼ hááheeshchiiʼí	Prunus dulcis
Łóóʼ bigaan tseebíí	Octopoda
Chʼosh bikágí ntłʼizí	Brachyura
Tábąąstííntsoh bideeʼ hólónígíí	Odobenus rosmarus
Mágí diʼilí	Pongo (zoologia)
Atsátsoh	Aquila chrysaetos
Łóóʼtʼą́hí atsiniltłʼish ííłʼínígíí	Torpediniformes
Chʼil łitsxooí ntsxaaígíí	Citrus × paradisi
Kʼíníjíłʼahí (dííshjį́ ááłjiní)	Ribes uva-crispa
Kʼaalógiiłgaígíí	Pieridae
Naʼastsʼǫǫsí binááʼ áłtsʼíísígíí	Soricidae
Dzaanééz	Mulo
Tsinlátah shash łichíʼígíí	Ailurus fulgens
Tsídii jáádnézí	Phoenicopterus
Tééh łééchąąʼí	Hyaenidae
Łóóʼtsoh dootłʼizhígíí	Balaenoptera musculus
Sóól	Acer (botanica)
Aghaaʼ	Lana
Deesdoigi	Zona torrida
Shádiʼááhdę́ę́ʼ tłʼízí	Lama glama
Mósíʼilí	Persiano (razza felina)
Lókʼaatah mósí ałchiní	Felis chaus
Náátsʼózídę́ę́ʼ mósíłkizhii ałchinígíí	Prionailurus bengalensis
Náshdóítʼą́ʼí łikizhígíí	Leptailurus serval
Tábąąh béégashii	Bubalus bubalis
Béégashiitsoh naʼałkǫ́ǫ́ʼígíí	Trichechus
Hastiin Leiw Éíwiksson	Leif Erikson
Akágí yitsʼǫǫsii	Hirudinea
Anáʼálwoʼ:TʼAN (FAQ)	Aiuto:FAQ
Táłkááʼ tsʼin	Crocodylidae
Chidítsoh	Autocarro
Dlǫ́ʼiitsoh áłtsʼózígíí	Genetta
Gáagii	Corvus
Tó wónaanídę́ę́ʼ náshdóí	Lynx lynx
Jááłánii (bitsiitsʼiin nteelígíí)	Chilopoda
Giní	Falco
Dahiitį́hii	Trochilidae
Tsídii biyęęzhtsohígíí	Apteryx
Tązhii	Meleagris
Chʼosh (Bíígháán Ádaadinígíí)	Invertebrata
Gáagii naashchʼąąʼígíí	Coraciidae
Mąʼii	Canis latrans
Dah Naatʼaʼí Sǫʼ bił Sinil	The Star-Spangled Banner
Akʼah sisíʼí tsin	Eucalyptus
Gahtsoh	Lepus (genere)
Bisóodi bíchį́į́h nineezí	Orycteropus afer
Sonora Hahoodzo	Sonora
Nahakʼízii	Gryllidae
Chaaʼ	Castor (zoologia)
Chʼilzooł	Brassica oleracea var. italica
Kááʼtsʼiní	Dasypodidae
Atsʼiis naałdzid	Carcinoma del polmone
Yágháhoníkáángóó ałánátʼahí	Space Shuttle
Méhigo tééh	Valle del Messico
Nahatʼeʼiitsoh łichíiʼii	Macropus rufus
Azeeniłchin	Lamiaceae
Chʼał	Anura
Tsxilghááh	Caudata
Shádiʼááhdę́ę́ʼ atsátsoh	Harpia harpyja
Shádiʼááhdę́ę́ʼ chʼał kʼaasdáhígíí	Dendrobatidae
Chʼał niłtólí	Centrolenidae
Chʼał dichʼízhí	Bufonidae
Tónteel tsídiitsoh	Diomedeidae
Chidí nadlééh	Cabriolet
Chʼał atʼąąʼ nahalinii	Megophryidae
Naashgalí	Mescaleros
Bisóodi ałchiní	Sus scrofa
Naʼastsʼǫǫsí dóó Łéʼétsoh Danilínígíí	Muroidea
Mariner 10	Mariner 10
Sǫʼ łóóʼ bigaanézí	Ophiuroidea
Dághaałóóʼ	Siluriformes
Łóóʼtʼą́hí	Pleuronectiformes
Toohjįʼ ndiigaii	Egretta thula
Kʼaalógii bitseeʼ hólóní	Papilionidae
Mágí binááʼtsohígíí	Tarsius
Tó wónaanídę́ę́ʼ dlǫ́ʼiiłkizhii	Vormela peregusna
Díłdánii	Odontophoridae
Táłtłʼááh łį́į́ʼ	Hippocampus
Łóóʼ bíígháántsiighąąʼ ádaadinígíí	Myxiniformes
Béésh Sinil	Winslow (Arizona)
Achʼįʼ Náhiłtį́į́	Safford
Tó wónaanídę́ę́ʼ dzeeh	Cervus elaphus
Tsézhin Deezʼáhí	St. Johns (Arizona)
Béésh Bá Hooghan	Globe (Arizona)
Kinłání (Hoozdoh Hahoodzo)	Flagstaff (Arizona)
Michoacán Hahoodzo	Michoacán
Tʼiisyaakin	Holbrook (Arizona)
Naʼníʼá Hótsaa	Page (Arizona)
Táłtłʼááh chʼosh daadánígíí	Caridea
Mágíshzhin	Pan (zoologia)
Łóóʼntsxaaí łikizhígíí	Rhincodon typus
Dlǫ́ʼii yił Aheedaałtʼéhígíí	Herpestidae
Béésh Bichʼahníí Bikéyahdę́ę́ʼ ayání	Bison bonasus
Łóóʼtsoh bitsiiʼ dikʼání	Physeter macrocephalus
Waaʼ (dííshjį́ ááłjiní)	Spinacia oleracea
Néʼéshjaatsoh	Bubo virginianus
Shádiʼááhdę́ę́ʼ tłʼízíʼilí	Vicugna pacos
Chʼosh ditłʼooí	Bruco
Łóóʼ bigaan neeznání	Teuthida
Bijáád noodǫ́ǫzii	Okapia johnstoni
Méhigo Hahoodzo	Messico (stato)
Ayání	Bison bison
Mąʼiiłgaii	Alopex lagopus
Táłtłʼááh chʼosh chʼééh digháhii bideetsohígíí	Anaspidea
Gólízhii Danilínígíí	Mephitidae
Táłtłʼááh adijiłii	Echinoidea
Nahachagii	Caelifera
Tsídiitsoh ditsʼozígíí	Dromaius novaehollandiae
Ałhaʼdeetʼaah	Contratto
Naayééʼ tsídii	Archaeopteryx lithographica
Tsísʼná (bitłʼizh ííłʼínígíí)	Apis
Chééwokii dinéʼiʼ	Cherokee
Tsin naaʼeeł hééł bee nágéhéʼ	Nave cargo
Ałtį́į́ jikʼáshí áłtsʼózígíí (chʼil)	Equisetum arvense
Yéigo ałhoshii	Gliridae
Naʼashjéʼii bijéí dah łichíiʼii	Latrodectus mactans
Mágí dághaaʼígíí	Saguinus imperator
Didzéłchííʼ	Ilex
Naałání	Comanche
Oozéí / Ayahkinii	Hopi
Toohjįʼ noołnahiitsoh	Ardea goliath
Bidááʼ Haʼaztʼiʼ Tsékooh	Grand Canyon
Táłtłʼááh naʼashjéʼii	Argyroneta aquatica
Táłtłʼááh tsisteełtsoh	Dermochelys coriacea
Tsídii yáłtiʼí yázhí	Melopsittacus undulatus
Tábąąh mąʼii	Procyon lotor
Hołchʼíʼí	Urtica
Dáághahii dinéʼiʼ	Francesi
Shash łizhinígíí	Ursus americanus
Náshdóí bizaʼazis hólóní	Thylacinus cynocephalus
Shash bitéélgaígíí	Ursus thibetanus
Chʼoshtʼą́hí	Platyhelminthes
Hashtłʼish jeeshóóʼ	Gypaetus barbatus
Jádí bíchį́į́htsohígíí	Saiga tatarica
Táłtłʼááh chʼoshtsoh chʼééh digháhii	Holothuroidea
Chidí naatʼaʼí dilwoʼí	Aereo da caccia
Bíchį́į́h naatsʼǫǫdí	Tapirus
Tó wónaanídę́ę́ʼ mąʼii	Canis aureus
Chʼóshgai (tsin)	Picea glauca
Łóóʼ Bigaan Dahólónígíí	Cephalopoda
Naʼashǫ́ʼii łóóʼ	Anguilliformes
Dahbaʼ (tsin)	Fraxinus
Łóóʼ hashkéhétsoh	Carcharodon carcharias
Neeshchʼííłchííʼ	Castanea
Chį́į́hnézí nahatʼeʼígíí	Macroscelididae
Táłtłʼááh ayání	Dugong dugon
Dibé Diníí Bikéyahdę́ę́ʼ náshdóí	Lynx pardinus
Maadíséloo	Monticello (Utah)
Kʼaiʼ Bił Hahazteel	Kanab
Toohjįʼ ndiigaiitsoh	Ardea alba
Wóóneeshchʼįįdii	Cicadidae
Dééshzhiin	Cygnus atratus
Naakaii náásééł	Mantodea
Dlǫ́ǫ́ʼ ntsxaaígíí	Hydrochoeris hydrochaeris
Mąʼii bijaaʼtsohí	Vulpes zerda
Dilchaʼ	Marmota
Náshdóí łibáhígíí	Lynx rufus
Chʼilhaatʼaʼii	Falco columbarius
Tééh hóyáaniitsoh	Delphinapterus leucas
Jádí bideeʼ yisdizígíí	Aepyceros melampus
Náátsʼózídę́ę́ʼ mąʼiiłchííʼ	Cuon alpinus
Łóóʼtsoh bighą́ą́ʼ yílkʼidígíí	Megaptera novaeangliae
Ghą́ą́ʼnaakiskʼidii	Camelus bactrianus
Tábąąh mąʼiiniiʼí	Nyctereutes procyonoides
Naʼazhǫǫsh (ndajiné dóó adazhdikaʼgi)	Casa da gioco
Dlǫ́tʼą́ʼí	Suricata suricatta
Azeeʼ hókániitsoh (chʼil daadánígíí)	Cynara scolymus
Kéchwa dinéʼiʼ	Quechua
Mąʼii bizaʼazis hólóní	Sarcophilus harrisii
Shash bítááʼłgaígíí	Tremarctos ornatus
Jádítsoh	Tragelaphus strepsiceros
Naatʼáanii Moctezuma II	Montezuma
Biwooʼ Ádaałtsʼíísígíí	Pilosa
Ásáí dinéʼiʼ bikéyah	Mondo arabo
Shash yázhí	Helarctos malayanus
Shash ndilnaʼii	Melursus ursinus
Teeł	Typha
Hwéeldi	Lunga marcia dei Navajo
Chʼódeenínii	Picea pungens
Łéʼétsoh yiljaaʼí	Ranunculus
Hakʼaz náshdóí	Lynx canadensis
Mąʼii yił Ałhidanoolinígíí Yázhí	Procyonidae
Béésh Bichʼahii beʼakétłʼóól dijoolí	Brassica oleracea gongylodes
Nahooyéí (chʼil naʼatłʼoʼii)	Convolvulus
Tłʼoh waaʼí nahalinígíí	Trifolium repens
Tábąąstííntsoh dághaaʼígíí	Erignathus barbatus
Atʼééké bijish yázhí	Brassica oleracea gemmifera
Tsékooh	Gola (geografia)
Noodah	Agave (botanica)
Łeeʼdoolʼeezí	Orobanchaceae
Kinteel Bił Hahoodzo	Contea di San Juan (Nuovo Messico)
Beeʼeldííl Dahsinil Bił Hahoodzo	Contea di Bernalillo
Aniłtʼánii	Neuroptera
Kʼaalógii bijáád dį́įʼii	Nymphalidae
Nímasii yiyání	Leptinotarsa decemlineata
Awééʼchíʼí (chʼil)	Campanula
Taʼaghálii	Astragalus
Naaʼołí yiltʼąąʼí	Lathyrus
Azeeʼ ndootʼeezhí łibáhígíí	Marrubium vulgare
Hastóí tsiiyéélí	Clematis
Chʼilátah atsʼos	Epilobium
Kʼish	Alnus incana
Dééłjáád	Rumex crispus
Kʼįįʼ	Rhus
Naaztání	Gleditsia triacanthos
Tsinyaa tłʼoh	Poa (botanica)
Tłʼééʼ yiigáhii	Oenothera
Tłʼoh deeskʼidí	Amaranthus retroflexus
Ndootʼeezhí	Monarda
Wóóseekʼidii	Sphingidae
Díkʼǫ́ǫ́zhí (chʼil)	Atriplex
Láʼashdlaʼ	Parthenocissus quinquefolia
Tséghániłchʼi	Portulaca oleracea
Tséyaa hataałí	Brassica napobrassica
Tłʼohtsʼózí	Juncus
Tłʼoh dichʼíízh	Carex
Shashdą́ą́ʼ	Berberis
Díkʼǫ́ǫ́zhí yiltʼąąʼí	Chenopodium album
Bįįh yildeeʼí	Physalis
Kʼaalógii bitʼaʼ ndikʼąʼ nahalinígíí	Lycaenidae
Hosh niteelí	Opuntia
Chʼał nineezí	Lithobates catesbeianus
Tééh hóyáanii bíchį́į́htsahí	Monodon monoceros
Mágí bíchį́į́htsohígíí	Papio
Bįįh łikizhígíí (Béésh Bichʼahníí Bikéyahdę́ę́ʼígíí)	Dama dama
Tábąąh ayání	Syncerus caffer
Nátʼostsoh	Verbascum thapsus
Dibé diníí dinéʼiʼ	Spagnoli
Binaʼadaałtzózí	Giapponesi
Dzidzé ditʼódí	Amelanchier alnifolia
Gad yił aheełtʼéhígíí	Tamarix
Łóóʼ bíchį́į́h nineezí	Xiphias gladius
Binááʼ Ádaałtsʼózí bichʼil łigaií	Brassica rapa pekinensis
Kolíya Tááʼ Bikéyahą́ą	Tre regni di Corea
Iiʼnótʼį́į́	Infezione
Chʼah Diʼilii Bikéyahdę́ę́ʼ mósí ałchinígíí	Felis manul
Tááʼyaʼniiltʼóshiiłbáhígíí	Cardinalis sinuatus
Jááłánii (bikágí ntłʼizígíí)	Diplopoda
Iichʼąhii ntsxaaígíí	Attacus atlas
Łóóʼ ńdídzihígíí	Dipnoi
Chʼíshiibeezhii	Paridae
Giní jáádnézí	Sagittarius serpentarius
Hakʼaz néʼéshjaaʼ	Bubo scandiacus
Shádiʼááhdę́ę́ʼ jeeshóóʼ	Vultur gryphus
Chidí naatʼaʼítsoh beeʼeldǫǫh bikǫʼ neiyéhé	Bombardiere
Shash bighą́ąʼgi hadzíbáhí	Ursus arctos horribilis
Kǫʼ naʼałbąąsii	Locomotiva a vapore
Ndíyíliitsoh	Helianthus annuus
Naaʼahóóhaiłkizhígíí	Numididae
Tłʼiish yighání	Mellivora capensis
Dadilhóni aheltłʼidígíí	Bomba a mano
Naakaii Łizhiní Bikéyahdę́ę́ʼ łééchąąʼí ałchiní	Lycaon pictus
Aniłtʼánii (tʼááłaʼajínígoʼígíí)	Ephemeroptera
Ayánítsoh bighą́ą́ʼaskʼidígíí	Bos gaurus
Máaz yikááʼ nandahí Spirit	Spirit
Hakʼaz giníłgaii	Falco rusticolus
Tsétah jeeshóóʼ łibáhí	Gyps fulvus
Tééh łééchąąʼí łikizhígíí	Crocuta crocuta
Tłʼízí ałchiní	Capra aegagrus
Yaaʼ dóó chʼosh bíchį́į́h dadichʼízhí	Acanthocephala
Beeʼeldǫǫh	Moschetto
Chʼosh bitsʼaʼígíí bigaan dahólónígíí	Brachiopoda
Tʼąąʼdoolghasí (daadánígíí)	Cichorium endivia
Dlǫ́ʼii (bílaʼashdlaʼii bilį́į́ʼ)	Mustela putorius furo
Łóóʼtsoh łibáhígíí	Eschrichtius robustus
Chʼah Diʼilii Bikéyahdę́ę́ʼ atsátsoh	Aquila nipalensis
Yiisnááh	Prigioniero di guerra
Dzeeh	Cervus elaphus canadensis
Tsinlátahgi tsídii nahatʼeʼígíí	Coliidae
Nátʼoh (chʼil)	Nicotiana tabacum
Tsin naaʼeeł bee daʼahijighánígíí	Nave da battaglia
Tsísʼná yiyání	Meropidae
Bisóodi bizęęs dį́įʼii	Phacochoerus africanus
Dlǫ́ʼiitsoh naalzheehígíí	Cryptoprocta ferox
Nahachagii biyázhí	Aphidoidea
Naalkʼįhiitsoh	Dermoptera
Łóóʼ naatʼaʼí	Exocoetidae
Hakʼaz ayání	Ovibos moschatus
Tsétah gah	Ochotona
Mąʼiitsoh bikʼos bineʼdę́ę́ʼ łizhinígíí	Chrysocyon brachyurus
Iichʼąhiitsʼósí	Trichoptera
Kéyah Dańlínídę́ę́ʼ atsátsoh	Pithecophaga jefferyi
Tábąąstííntsoh bíchį́į́htsohígíí	Mirounga
Łóóʼntsxaaí díníchʼahii	Cetorhinus maximus
Chʼosh yighání	Proteles cristatus
Mágí bitseeʼ noodǫ́zígíí	Lemur catta
Táyiʼ chʼoshnézí	Nemertea
Dlǫ́tsʼósí łibáhígíí	Mungotictis decemlineata
Tó naagoʼ	Goccia
Dlǫ́ʼiitsoh Danilínígíí	Viverridae
Mágí bigaanézí	Hylobatidae
Bílaneezii	Daubentonia madagascariensis
Séí mąʼii	Vulpes corsac
Naalʼeełítsoh bitéél halchíʼí	Branta ruficollis
Tłʼízí bideeʼ yisdizígíí	Capra falconeri
Jádí	Antilocapra americana
Wónikǫsí	Phasmatodea
Tééh łééchąąʼí noodǫ́zígíí	Hyaena hyaena
Tsídiiłchxoní	Opisthocomus hoazin
Táłtłʼááh chʼoshtʼą́hí bikááʼtsʼinígíí	Polyplacophora
Mąʼii bighą́ąʼgi hadzíjiní	Canis mesomelas
Naakaii Łizhiní Bikéyahdę́ę́ʼ mąʼiiłchííʼ	Canis simensis
Tsétah dibé	Ovis canadensis
Dibé dóó Tłʼízí Ndahalinígíí	Caprinae
Mágí bíchį́į́h dootłʼizhígíí	Mandrillus sphinx
Tsiighájíłchí	Cuscuta
Bįįhyázhí biwooʼnézí	Moschus moschiferus
Dzeeh łikizhígíí	Cervus nippon
Tábąąh mósí ałchiní	Prionailurus viverrinus
Chį́į́h yee achʼiishíhii	Pristidae
Shádiʼááhdę́ę́ʼ hodíłchʼil mąʼii	Speothos venaticus
Hakʼaz mágí	Macaca fuscata
Tsé Biiʼ Ndzisgaii	Monument Valley
Mágí bíchį́į́h niilyoolígíí	Nasalis larvatus
Shádiʼááhdę́ę́ʼ tsídiitsoh	Rhea americana
Dáádílí łibáhígí	Epinephelus marginatus
Náátsʼózídę́ę́ʼ mósíłtsxooí ałchinígíí	Pardofelis temminckii
Łóóʼnteeltsoh	Mola mola
Gaanłáníchilí dóó Gaanłání doo yitʼíinii	Hydra (zoologia)
Atłʼóóh	Tessitura
Chʼoshkʼaaʼ	Chaetognatha
Tábąąh bįįh	Hydropotes inermis
Hodíłchʼil jeeshóóʼ	Sarcoramphus papa
Dlǫ́ǫ́ʼ bitseetłʼooígíí	Chinchilla
Achʼąąʼ adáʼatsʼiʼ	Vaccinazione
Néʼéshjaaʼ bíńdáhii	Surnia ulula
Bitseeʼ yee adiłhałii	Alligator mississippiensis
Jádítsoh noodǫ́zígíí	Tragelaphus eurycerus
Níyolgi naatʼaʼígíí (tónteel tsídii)	Hydrobatidae
Tádídíín yiyání	Chrysomelidae
Tsídiidaashiyishí	Threskiornithinae
Shádiʼááhdę́ę́ʼ łéʼétsoh bitseeʼ ádinígíí	Dasyproctidae
Chʼosh bitsʼaʼłáaʼii	Monoplacophora
Naʼashǫ́ʼii łóóʼ hashkéhé	Chlamydoselachus anguineus
Jeeshóóʼ	Gymnogyps californianus
Chʼosh dilwoʼígíí	Cicindelinae
Chʼosh doo yitʼíinii bee nílʼíní	Microscopio
Tsin ditʼinii	Spermophilus
Joogii	Cyanocitta cristata
Łeeyiʼ nahakʼízii	Gryllotalpidae
Náátsʼózídę́ę́ʼ naalʼeełí	Aix galericulata
Mąʼii bijaaʼabanígíí	Otocyon megalotis
Tsídiitsoh bikʼos dootłʼizhí	Casuarius
Atsiniltłʼish ííłʼíinii (naʼashǫ́ʼii łóóʼ)	Electrophorus electricus
Dįʼ	Tetraoninae
Niicháadii (łóóʼ)	Tetraodontidae
Tééhoołtsódiichilí	Hexaprotodon liberiensis
Kʼiiznoodǫ́ǫzii (tsin yigházhígíí)	Cuniculus
Wóláchííʼ yildeełítsoh	Myrmecophaga tridactyla
Bináʼadaałtsózí bitsin naaʼeeł	Giunca
Níłtsą́goʼ (bideeneezígíí)	Cerambycidae
Tséʼédǫ́ʼii bitsiinézí	Mecoptera
Tłʼohtahgi díłdánii yił aheełtʼéhii	Turnicidae
Łóóʼyiniʼįįhí (tónteel tsídii)	Skua
Shádiʼááhdę́ę́ʼ tó hóyáanii	Inia geoffrensis
Naʼashǫ́ʼiitsoh	Iguana
Łóóʼ adishishí	Dasyatidae
Tsin yąąh dzootʼihí	Sitta
Atʼaʼ yiltʼąąʼí dah sidáhígíí (chʼosh ntsxaaígíí)	Birgus latro
Yółeehii	Lophiiformes
Tiníléí	Heloderma suspectum
Tłʼoh	Prato rasato
Dinas	Arctostaphylos uva-ursi
Mąʼii bikʼiizgi hadzíjiní	Canis adustus
Yadiizį́įgo ayání	Litocranius walleri
Télii bijáád noodǫ́zí	Equus africanus
Bitsʼáá bidaʼhodiʼniil	Terra bruciata (guerra)
Mágíłchííʼ	Leontopithecus rosalia
Dááʼadeeʼii	Platalea
Łóóʼ hashkéhé bitsiiʼ dikʼání	Sphyrnidae
Taahilnoodii	Sulidae
Kʼíneedlíshii adiłhashígíí	Lucanidae
Łééh yidi tóʼígíí	Falda acquifera
Naʼashǫ́ʼiitsoh naʼałkǫ́ʼígíí	Amblyrhynchus cristatus
Tsídiisháshii	Bombycilla
Naakétłʼáhí	Pima
Yaaʼ bitsʼaʼígíí	Coccoidea
Daateel	Cochlearius cochlearius
Tééh łééchąąʼí ditsʼozígíí	Parahyaena brunnea
Tsétaʼ łį́į́ʼ	Mustang (cavallo)
Kénézí	Jacanidae
Neeshchʼííʼ	Pinolo
Naalʼeełítsoh yił aheełtʼéhii łizhin dóó łigaiígíí	Anseranas semipalmata
Mąʼii chʼil	Solidago
Yaadaaʼnézí (tónteel tsídii)	Rynchops
Tsídii disxǫsígíí	Galbulidae
Náátsʼózídę́ę́ʼ mósíłchíiʼii ałchinígíí	Pardofelis badia
Shádiʼááhdę́ę́ʼ tsétah mósí ałchinígíí	Leopardus jacobita
Tsinlátahgi dlǫ́ʼiitsoh	Arctictis binturong
Jeeshóóʼ łizhinígíí	Coragyps atratus
Naałʼashí	Theraphosidae
Dééłdą́ą́ʼ	Pteridium aquilinum
Hashkʼaan yildeełígíí (tsídii)	Musophagidae
Łį́į́chilí	Shetland (cavallo)
Daakʼį́į́ʼ	Numenius
Mąʼiiłtsooí łibáhígíí	Urocyon cinereoargenteus
Naʼashǫ́ʼiitsoh dootłʼizhígíí	Iguana iguana
Chidí bikéíjį́ʼ adeizʼááhígíí	Pick-up (veicolo)
Bįįh bitseełgaiígíí	Odocoileus virginianus
Wónitłʼizí	Oniscidea
Díʼdikii (jádí)	Madoqua
Hakʼaz mąʼiitsoh	Canis lupus arctos
Dark Ages	Secoli bui
Tłʼoh naadą́ą́ʼ biyaʼ	Sitophilus granarius
Łeeyiʼ jááłániichilí	Pauropoda
Tséʼédǫ́ʼii dishooí	Syrphidae
Tsáʼásziʼ dóó Noodah	Agavaceae
Tééh tsisteeł	Chelonioidea
Bichʼah Dootłʼizhii	Peacekeeping
Dlǫ́ʼii łizhin dóó łitsooígíí	Martes flavigula
Chʼosh ałchozhii (chéłchaaʼ)	Dermestidae
Łeʼesoołii (bitseeʼ naakiígíí)	Diplura
Dlǫ́ʼátsoh	Marmota monax
Chʼééh digháhii dóó Tsisteeł	Testudines
Tááʼyaʼniiltʼóshii	Cardinalidae
Łeʼesoołii (bitseeʼ tááʼígíí)	Thysanura
Tłʼézhii	Tabanidae
Tániilʼáítsʼóóz	Zygoptera
Naashtʼézhí	Zuñi
Aniłtʼániitsʼóóz	Myrmeleontidae
Tó wónaanídę́ę́ʼ hazéí bíchį́į́hnézí	Scandentia
Hakʼaz gah	Lepus arcticus
Bįįh łikizhígíí (Naakaii Dootłʼizhii Bikéyahdę́ę́ʼígíí)	Axis axis
Nahashchʼidí (naaldeehii)	Taxidea taxus
Tsídii bichʼahtsooígíí	Buceros bicornis
Shádiʼááhdę́ę́ʼ bisóodi diʼilígíí	Tayassuidae
Náʼagéédí bizaʼazis hólóní	Notoryctes
Tłʼézhiiłbáhí	Tachinidae
Shash nátʼoh	Tribulus terrestris
Jádítsoh diłhiłígíí	Tragelaphus angasii
Jádítsoh bideeʼ shiyishígíí	Hippotragus niger
Dlǫ́ʼiitsoh łikizhígíí	Civettictis civetta
Tsinaʼayąʼii yildeełí	Myrmecobius fasciatus
Tsétah tłʼízí	Oreamnos americanus
Jááłániichilí bighádzígaiígíí	Symphyla
Gahchilí	Brachylagus idahoensis
Dééłgai bitsiiʼ halzhinígíí	Cygnus melancoryphus
Chʼosh nahachagii	Cicadellidae
Hóółtseiigi naʼastsʼǫǫsí	Gerbillinae
Gaanłání	Ceriantharia
Tádídíín yiyání łichíʼígíí	Lilioceris lilii
Laanaa Yáʼátʼéehgo Késhmish	We Wish You a Merry Christmas
Naʼazǫ́ǫzii	Mutillidae
Jáád neishoodí (naʼashjéʼii haalzheehígíí)	Pompilidae
Naalʼeełí bidaatsʼózí	Mergus
Naalʼeełí łizhinígíí	Melanitta
Nahatʼeʼiitsoh Bikéyahdę́ę́ʼ naalʼeełítsoh łibáhígíí	Cereopsis novaehollandiae
Dahsánítsoh	Hystrix cristata
Naʼastsʼǫǫsí bitseeʼ dichʼízhí	Acomys
Tsétah nahatʼeʼiitsoh	Petrogale
Táłkááʼ dilwoʼí	Gerridae
Akáshtʼóózh biyaʼ	Psocoptera
Łeʼesoołii (bideeʼ ádinígíí)	Protura
Ąąʼąʼii	Pica (zoologia)
Jádí bideeʼ dį́įʼii	Tetracerus quadricornis
Táłtłʼááh chʼosh ntsxaaígíí	Macrocheira kaempferi
Mósí ałchiní bitsiiʼtʼąhígíí	Prionailurus planiceps
Naakaii Łizhiní Bikéyahdę́ę́ʼ naalʼeełítsoh dibéłchíʼígíí	Alopochen aegyptiaca
Hosh aditsahiitsoh	Carnegiea gigantea
Tʼáá łichíʼígo náʼagéédí	Heterocephalus glaber
Tsisteeł łizhinígíí	Chelonoidis carbonarius
Tééh jeeshóóʼ	Gyps africanus
Ghą́ą́ʼnoodǫ́ǫzii (tsin yigházhígíí)	Dinomys branickii
Tsáʼásziʼ bideeʼí	Yucca baccata
Łéʼétsoh beeniʼíhoniitaahígíí	Cavia
Ásaaʼ neiyéhii	Meloidae
Naʼashǫ́ʼiitsoh łitsooígíí	Conolophus subcristatus
Shádiʼááhdę́ę́ʼ tiníléí	Heloderma horridum
Tsé Bighánílíní	Antelope Canyon
Naakaii Dootłʼizhii bimósí ałchinígíí	Prionailurus rubiginosus
Kʼaabizhii	Mammillaria
Dahiitį́hídą́ą́ʼtsoh	Castilleja
Wálázhini	Messor
Jáád neishoodí (łeyiʼdi bighanígíí)	Sphex
Chʼał bikʼos ádinígíí	Nasikabatrachus sahyadrensis
Jéí náyoogisii	Echinocereus
Tłʼohtah náshdóí	Leopardus pajeros
Tsídii naʼałkǫ́ʼígíí	Fratercula
Tsisteeł diyogí	Chelus fimbriata
Łóóʼ adishishí ntsxaaígíí	Manta birostris
Tónteel bibąąh hóyáanii	Neophocaena phocaenoides
Naakaii Łizhiní Bikéyahdę́ę́ʼ tsétah dibé	Ammotragus lervia
Náhookǫsdę́ę́ʼ dlǫ́ʼii	Martes americana
Naalʼeełí naashchʼąąʼígíí	Aix sponsa
Tsinlátah nahatʼeʼiitsoh	Dendrolagus
Tsin naaʼeeł łóó beeʼháʼhaalʼééłiʼ	Peschereccio
Chʼosh biyaʼ	Strepsiptera
Táłtłʼááh chʼosh	Dytiscidae
Gáagii dinéʼiʼ	Crow
Shádiʼááhdę́ę́ʼ tábąąstííntsoh	Otaria flavescens
Táłtłʼááh álééh	Ardea herodias
Tsísʼnáłtsooítsoh	Vespa (zoologia)
Táłtłʼááh naakaii náásééł yił aheełtʼéhii	Stomatopoda
Náátsʼózídę́ę́ʼ tsiiłtsooí	Chrysolophus pictus
Bisóodi Danilínígíí	Suiformes
Gólízhii noodǫ́zígíí	Mephitis mephitis
Naʼastsʼǫǫsí bijaaʼntsxaaígíí	Macrotis lagotis
Tsʼání	Gymnorhinus cyanocephalus
Chʼééh digháhii bitsʼaʼ yilzhólí	Trionychidae
Chį́į́shghą́ʼiiłgaii	Sitta carolinensis
Hastiin Diego de Landa	Diego de Landa
Hastiin Biʼééʼ Łichíiʼii	Kit Carson
Tábąąstííntsoh (Akééháshį́į́dę́ę́ʼígíí)	Zalophus californianus
Mósí bizaʼazis hólóní	Dasyurus
Tségad	Selaginella
Tsįyaalzhahí	Accipiter striatus
Hashtłʼishdi chʼééh digháhii	Kinosternidae
Bichʼáh yiisdiisí	Australiani anglo-celtici
Yaaʼ nahachagiígíí	Siphonaptera
Kéʼ łizhiní	Confederazione dei Piedi Neri
Tábąąsdísí áłtsʼíísí	Actitis macularius
Náátsʼózídę́ę́ʼ toohjįʼ ndiigaii	Egretta eulophotes
Łóóʼtsoh (Ałtsʼáʼáztiin)	Balena (disambigua)
Dlǫ́ʼii łizhiní	Mustela nigripes
Wóláchííʼ yildeełí łizhin dóó łigaígíí	Tamandua
Lókʼaatah bisóodi	Potamochoerus larvatus
Hodíłchʼil tłʼízí	Capricornis sumatraensis
Hakʼaz Dineʼé Bikéyahdę́ę́ʼ tábąąstííntsoh	Eumetopias jubatus
Dziłtah dlǫ́ʼii	Mustela altaica
Naayééʼ tsídiitsoh	Dinornithidae
Atseełtsoii	Buteo jamaicensis
Tóniłhę́ęshii (dééł)	Grus americana
Naaltsoos Mormon Wolyéhígíí	Libro di Mormon
Dlǫ́ʼátah néʼéshjaaʼ	Athene cunicularia
Naʼashǫ́ʼii bijáád ádinígíí	Amphisbaenia
Naʼatłʼoʼii (chʼosh)	Embioptera
Dííłdzid yiyání	Staphylinidae
Tʼiisbáí	Populus tremuloides
Tłʼéeʼgo mágí	Aotidae
Tsʼíʼii jáádnézí	Tipulidae
Chʼil ditsʼozíłchííʼ	Nephelium lappaceum
Mágíłtsooí bináázhiní	Saimiri sciureus
Taʼneeskʼání	Melone di Cantalupo
Tsídiiłtsooí bitʼaʼ łizhinígíí	Spinus tristis
Tsʼíʼii noodǫ́zí	Aedes albopictus
Anaasází	Anasazi
Chʼééh digháhiitsoh	Chelonoidis niger
Yeenaʼałkǫ́ʼíłániichilí	Remipedia
Naʼnízhoozhí Bił Hahoodzo	Contea di McKinley
Mąʼii Deeshgiizh Bił Hahoodzo	Contea di Sandoval
Naatoohí Bił Hahoodzo	Contea di Cibola
Tábąąstííntsoh łikizhígíí	Phoca largha
Ooljééʼ yiikááʼ nandahí	Allunaggio
Toohjįʼ noołnahii yázhí	Butorides virescens
Báshdo	Barstow (California)
Łóóʼ hashkéhé bíchį́į́hnézí	Mitsukurina owstoni
Tłʼiishtsiiʼí (łóóʼ)	Channidae
Chéłchaaʼ bideeneezígíí	Dynastes hercules
Déłí	Grus canadensis
Tsétah chaaʼ	Aplodontia rufa
Sighóla	Socorro (Nuovo Messico)
Chéłchaaʼ disxǫsígíí	Buprestidae
Naalʼeełí dootłʼizhí	Anas discors
Béíyózhin	Paiute
Tsin naabąąs	Carro coperto
Tó Hasłeeh	Mancos
Dlǫ́tsʼósí łichííʼígíí	Galidia elegans
Jádídlǫ́ʼii	Troglodytes aedon
Tłʼohchintó	Hotevilla-Bacavi
Tséʼédǫ́ʼii	Muscidae
Dahsání dah Yikahjí Tsin Deigházhígíí	Hystricomorpha
Níyolgi naʼałkǫ́ʼígíí (tónteel tsídii)	Pelecanoides
Tsinaʼayąʼii biyázhí	Zoraptera
Tłʼízíʼilí	Capra d'Angora
Naatooh Sikʼaiʼí	Grants
Tsooʼtsʼiní (łóóʼ)	Osteoglossidae
Tsinaʼayąʼii	Isoptera
Náʼagéédí bíchį́į́h sǫʼ nahalinígíí	Condylura cristata
Naaléełchííʼ	Rhynchopsitta pachyrhyncha
Naaʼahóóhai disxǫsígíí	Lophophorus
Náhookǫsdę́ę́ʼ tsétah dibé	Ovis dalli
Naʼnízhoozhí	Gallup
Neeshchʼíínímazí	Nocciola
Łóóʼ binááʼtsohí	Priacanthidae
Tsisteeł bikʼosneezígíí	Chelidae
Kilim	Kilim
Ałtaʼneetsʼéhii	Xanthium
Wáláchíʼétah nahachagiichilí	Myrmecophilidae
Yáhashjool yił aheełtʼéhii	Eurypyga helias
Tsintah bisóoditsoh	Hylochoerus meinertzhageni
Zééjíjinii	Chauna torquata
Tóikałí	Artemisia frigida
Kááʼtsʼiní ditłʼooígíí	Chaetophractus
Naalkʼįhíchilí (bizaʼazis hólónígíí)	Acrobates pygmaeus
Dlǫ́ʼii yił aheełtʼéhii łibáhígíí	Herpestes edwardsii
Adijiłii yił aheełtʼéhí	Echinops telfairi
Łóóʼ hashkéhé bitseeneezígíí	Alopias vulpinus
Chį́į́shłigaií dóó Naalʼeełítsoh	Anserinae
Jádí biniiʼtsʼózí	Alcelaphus buselaphus
Tábąąh jádí	Kobus ellipsiprymnus
Jádí binááʼ dį́įʼii	Beatragus hunteri
Tó wónaanídę́ę́ʼ dlǫ́ʼáyázhí	Spermophilus citellus
Ásáí Dineʼé Bikéyahdę́ę́ʼ mąʼiitsoh	Canis lupus arabs
Dlǫ́iitsoh bíchį́į́hdzísgaiígíí	Paguma larvata
Aniłtʼánii yázhí	Psyllidae
Sǫʼ tsisteeł	Astrochelys radiata
Mąʼii dootłʼizhí	Bassariscus astutus
Táłkááʼ dilwoʼítsʼóóz	Hydrometridae
Łeʼesoołii (nahachaʼígíí)	Machilida
Tóidoozohii bidaaʼ łigaiígíí	Fulica
Chéłchaaʼtsoh	Dynastinae
Wódisxǫsí	Scutelleridae
Tsisteeł hashkéhé	Chelydridae
Naʼastsʼǫǫsí bizaʼazis hólóní	Antechinus
Tsídiidą́ą́ʼ	Phlox
Wóniłchxoní	Pentatomidae
Tsiikʼánii (tsídii)	Scopus umbretta
Nahatʼeʼii niłchxoní	Hypsiprymnodon moschatus
Náátsʼózídę́ę́ʼ tsiidootłʼizhii	Argusianus argus
Tábąąh bisóodiłchíiʼii	Potamochoerus porcus
Kéyah Dańlínídę́ę́ʼ naalʼeełí	Anas luzonica
Kézhoozhʼilí (tsin yigházhígíí)	Ctenodactylidae
Jádí bideeneezígíí	Oryx
Beehai	Apache Jicarilla
Tsísʼná náʼagéédígíí	Anthophorini
Mágíłbáhí	Cercopithecus mitis
Jaaʼditłʼoʼí naalkʼįhígíí (bizaʼazis hólónígíí)	Petauroides volans
Nahatʼeʼiitsoh yázhí	Thylogale
Séí tiníléítsoh	Varanus gouldii
Dlǫ́ʼii yił aheełtʼéhítsʼózí	Galerella sanguinea
Tółání	Laguna (Nuovo Messico)
Łóóʼ bigháhootʼíní	Ambassidae
Tónhidigaii	Silverton (Colorado)
Chʼosh áłtʼą́ą́ʼígíí	Lygaeidae
Dééłtsoh	Ardeotis kori
Shádiʼááhdę́ę́ʼ dahsání	Coendou prehensilis
Nahatʼeʼiitsoh Danilínígíí	Macropodiformes
Dlǫ́ʼii bitseenézí	Mustela frenata
Kéyahígíí nidineesdzaʼ	Dust Bowl
Nahachagii dootłʼizhí	Tettigoniidae
Tsé Bíyah Aniiʼáhí	Parco nazionale storico della cultura Chaco
Nahatʼeʼiitsoh Bikéyahdę́ę́ʼ biyázhí neiyéhé	Trichosurus vulpecula
Tsísʼnádą́ą́ʼ	Gaillardia
Jeeshóóʼ ałchozhígíí	Gypohierax angolensis
Łóóʼ adiłdoní	Toxotidae
Dlǫ́ʼii yił aheełtʼéhii łitsxooígíí	Cynictis penicillata
Naakaii Łizhiní Bikéyahdę́ę́ʼ nahatʼeʼii	Pedetes capensis
Táłtłʼááh chʼosh chʼééh digháhii bitsʼaʼ ádinígíí	Nudibranchia
Tiníléítsoh noodǫ́zígíí	Varanus niloticus
Naʼashǫ́ʼii bideewozhii	Uromastyx
Chʼał ntsxaaígíí	Conraua goliath
Naalʼeełí (bílaʼashdlaʼii bilį́į́ʼ)	Anas platyrhynchos domesticus
Yáhashjool	Botaurus lentiginosus
Dlǫ́ʼii yił aheełtʼéhii yázhí	Helogale parvula
Nahatʼeʼiitsoh Bikéyahdę́ę́ʼ tábąąstííntsoh	Neophoca cinerea
Mąʼiiłtsooí yázhí	Vulpes macrotis
Gałbáhí	Sylvilagus
Tsékááʼgóó naagháhii (chʼosh)	Mantophasmatodea
Tłʼohtahilzhahí	Cariamidae
Táłtłʼááh tsxilghááhtsoh	Cryptobranchidae
Dibé dághaaʼígíí	Capricornis crispus
Chʼééh digháhii bitsiiʼntsxaaígíí	Platysternon megacephalum
Tsékʼi naʼałkǫ́ʼii	Galemys pyrenaicus
Kéyah Dańlínídę́ę́ʼ dzeeh dóó bįįh	Rusa
Naʼastsʼǫǫsítsoh (chʼosh yildeełígíí)	Solenodon paradoxus
Chʼagii	Agelaius phoeniceus
Łéʼétsoh diwozhí	Echinosorex gymnura
Łéʼétsoh bizaʼazis hólóní	Dasyuroides byrnei
Dlǫ́ʼiitsoh noodǫ́zígíí	Hemigalus derbyanus
Tábąąstííntsoh łizhin dóó łigaiígíí	Histriophoca fasciata
Jeeshóóʼ bitsiiłgaiígíí	Trigonoceps occipitalis
Tábąądijádí	Charadrius vociferus
Shádiʼááhdę́ę́ʼ niłchiis	Galictis
Naʼazísí	Geomyidae
Łeeyiʼ chʼał dichʼízhí	Rhinophrynus dorsalis
Táłtłʼááh naatʼáʼii	Dactylopteridae
Naakaii Dootłʼizhí Dabikéyah	Asia meridionale
Ńdaʼatʼaałii bideeʼ dahólónígíí	Pecora (infraordine)
Naaldlooshii	Quadrupede
Kinteel (Yootó Hahoodzo)	Aztec
Néʼétsah azeeʼ	Conyza canadensis
Atsá diłhiłígíí	Ictinaetus malayensis
Ąąʼąʼii dootłʼizhígíí	Cissa chinensis
Bisóodi dághaaʼígíí	Sus barbatus
Iichʼąhii biyázhí	Aleyrodidae
Kin Noodǫ́ǫ́z	Bernalillo
Hashtłʼishdi tádíʼnéehii	Oxudercinae
Tsiikʼánii (łóóʼ ooshgę́ęzhii)	Rhinobatidae
Mágí biniiłgaígíí	Pithecia pithecia
Wónaʼałtéhii	Asilidae
Tłʼoh azihii	Ephedra
Kʼaalógii bitʼaʼ disxǫsgo łikizhígíí	Riodinidae
Tiníléítsoh bikʼosnézí	Varanus griseus
Shádiʼááhdę́ę́ʼ gahniiʼí ntsxaaígíí	Dolichotis
Łéʼétsoh bitseetłʼooígíí	Petromus typicus
Tsídii bizééʼ naashchʼąąʼí	Tragopan
Tábąąsdísíłbáí	Limnodromus
Dilzhę́ʼii	Cyanocitta stelleri
Mágí naashchʼąąʼígíí	Pygathrix nemaeus
Łeeyiʼ bitiiní	Arvicolinae
Atsáłbáí	Falco mexicanus
Tsʼánídílzhiʼí	Aphelocoma californica
Iichʼąh	Convulsione
Kiisʼáanii	Pueblo (popolo)
Dlǫ́ʼii noodǫ́zígíí	Poecilogale albinucha
Tiníléítsoh dootłʼizhígíí	Varanus prasinus
Yáázhłání (naaldlooshii)	Tenrec ecaudatus
Łéʼétsoh yił aheełtʼéhii	Octodontidae
Tábąąh łéʼétsoh	Hydromys chrysogaster
Ghą́ą́ʼdiʼilii (tsin yigházhígíí)	Lophiomys imhausi
Lókʼaaʼ yigházhígíí	Thryonomys
Tsídii bitʼaʼ dah adadootłʼizhígíí	Polyplectron
Dichin	Inedia
Chį́į́hʼadeeʼii (łóóʼ)	Polyodontidae
Hazéíntsxaaígíí	Ratufa
Kéyah Dańlínídę́ę́ʼ bisóodi bizęęs hastání	Sus cebifrons
Chąąneiłmaasii	Scarabeo stercorario
Chʼałniiʼí (łóóʼ)	Batrachoididae
Dah Naatʼaʼí Bééhoʼdílzin	Pledge of Allegiance
Tó bichʼosh (tsiiyaago naʼałkǫ́ʼígíí)	Notonectidae
Tónteel táshchozhii	Sterninae
Naʼastsʼǫǫsí noodǫ́zígíí	Lemniscomys
Dóliiłchííʼ	Sialia mexicana
Łóóʼ binááʼ ádiní	Amblyopsidae
Naabiʼání	Bloomfield (Nuovo Messico)
Mágí bichį́į́łgaígíí	Cercopithecus ascanius
Tábąąh chʼosh	Saldidae
Naakaii Bikéyahdę́ę́ʼ bįįh yázhí	Mazama
Naʼashǫ́ʼii dootłʼizhí (naaldeehii)	Crotaphytus collaris
Naʼashǫ́ʼiiłbáhí	Dipsosaurus dorsalis
Dlǫ́tsʼósí noodǫ́zígíí	Galidictis grandidieri
Łéʼétsoh gahjaaʼígíí	Hypogeomys antimena
Chʼoshtsoh bíláshgaanʼilí	Kiwa hirsuta
Anáʼálwoʼ:Bee hadítʼéhígíí	Aiuto:Aiuto
Moháábii dinéʼiʼ	Mohave
Hodíílid	Dolores (Colorado)
Néʼéshjaaʼkálii	Micrathene whitneyi
Tsídii bitʼaʼ hózhóón	Paradisaea (zoologia)
Tiníléítsoh łikizhígíí	Varanus giganteus
Tiníléítsoh bíchį́į́h dikʼání	Varanus albigularis
Chʼiyíítʼogii	Tyrannus
Dloziłgaii	Tamiasciurus
Tsísʼná dootłʼizhí	Chrysididae
Halchíítah	Deserto Dipinto (Stati Uniti d'America)
Wóósitsʼílí	Cimex lectularius
Tsʼahgi naalnoodí	Sceloporus graciosus
Łéʼétsoh binááʼ ádiní	Spalax (genere)
Dlǫ́ʼiitsoh bizééʼ noodǫ́zí	Viverra tangalunga
Jaaʼabaní	Microchiroptera
Wóláchííʼ yildeełí	Vermilingua
Hastiin Chʼil Haajiní (Manuelito)	Manuelito
Dlozishzhiin	Sciurus aberti
Tó Sido Háálį́	Pagosa Springs
Tó Diłhił Biih Yílį́	Snowflake (Arizona)
Yoołgai (Hoozdoh Hahoodzo)	Superior (Arizona)
Tsé Noodǫ́ǫ́z	Springerville
Kin Łání (Dibé Nitsaa Hahoodzo)	Durango (Colorado)
Tségháhoodzání	Window Rock
Tsé Yaatóhí	Cortez (Colorado)
Tótaʼ	Farmington (Nuovo Messico)
Tó Naneesdizí	Tuba City
Tséhootsooí	Fort Defiance
Chʼínílį́	Chinle
Lókʼaaʼdeeshjin	Keams Canyon
Tséyiʼ (Chʼínílį́įgiʼígíí)	Canyon de Chelly
Chʼoshtsoh bíláshgaantsohí (tónteelgiʼígíí)	Nephropidae
Tábąąstííntsoh bighaaʼ díłchʼilígíí	Arctocephalinae
Dlǫ́ʼiiłtsooí	Martes melampus
Tsísʼnáłtsooí	Vespula
Azeeʼ hókánii łibáhígíí	Sonchus asper
Jélii łóóʼ daʼhólzhaʼígíí	Salpida
Gólízhii binághah dah łigaiígíí	Mephitis macroura
Dloziłbáhí	Sciurus griseus
Bikétłʼááh Hoolzhólígíí	Tylopoda
Tǫ́ʼgaaʼ	Cochiti
Oozéí Hasáanii	Old Oraibi
Táłtłʼááh séigoʼ bitsʼaʼígíí	Limulus polyphemus
Nááʼnoodǫ́ǫzii	Thlaspi
Tóidoozohii dootłʼizhígíí	Porphyrio
Jáád neishoodítsʼóóz	Ichneumonidae
Bitsiichįįshgahí	Nucifraga columbiana
Naʼashǫ́ʼii naatʼaʼí	Draco (zoologia)
Gólízhii bíchį́į́h tʼáá łichíiʼii	Conepatus
Iichʼąhii naashchʼąąʼígíí	Chrysiridia rhipheus
Wóóseetsʼiniiniłhiní	Rhaphidophoridae
Biniiʼnoodǫ́zí (tsin yigázhígíí)	Lagostomus maximus
Tsísʼnátsoh diłhiłígíí	Xylocopa
Shádiʼááhdę́ę́ʼ chʼoshtsoh bíláshgaantsohí	Parastacidae
Zábąąhnteelii (łóóʼ ooshgę́ęzhii)	Rhina ancylostoma
Sílátsoh (chʼil)	Rudbeckia laciniata
Gahjaaʼí bitseeneezígíí	Lagidium
Tłʼiish kʼaaʼ	Racer
Naaldlooshii Bikéshgaan Dahólónígíí	Ungulati
Nóódaʼí	Ute (popolo)
Tó Dínéeshzheeʼ	Kayenta
Táłkááʼ dilwoʼí yázhí	Veliidae
Néʼézhiin	Sphyrapicus nuchalis
Dlǫ́ʼii yił aheełtʼéhii diłhiłígíí	Galerella pulverulenta
Chʼosh bitsʼaʼ doolghasígíí	Pectinidae
Hashkʼaan bichʼosh	Prodoxidae
Tádídíín yiyání łizhinígíí	Timarcha
Niʼbéshjah	Amorpha
Tsídii bidaatsoh naashchʼąąʼí	Ramphastidae
Chʼał bikéshgaan hólóní	Xenopus
Tó bichʼosh (ałchozhígíí)	Corixidae
Nahashchʼidí yił aheełtʼéhii yázhí	Melogale
Dáánézí (łóóʼ)	Centriscidae
Tłʼiish bichóhí	Crotalus cerastes
Tsékʼi yaʼiiʼáhii	Manduca sexta
Táłkááʼ sikaadí	Cerastium arvense
Táłtłʼááh chʼosh chʼééh digháhii bitsiiʼ dikʼání	Cephalaspidea
Atʼaʼ éljołí nahalinígíí (táłtłʼááh chʼosh)	Sabellidae
Tʼááłáhági átʼéego:Bééshbichʼahí	Categoria:Germania
Tʼááłáhági átʼéego:Wááshindoon bikéyah ałhidadiidzooígíí	Categoria:Stati Uniti d'America
Táłtłʼááh kʼaaʼ (łóóʼ)	Fistularia
Tʼááłáhági átʼéego:Dibé diníí bikéyah	Categoria:Spagna
Tʼááłáhági átʼéego:Naakaii Bikéyah	Categoria:Messico
Wóódeʼełchíhii	Coreidae
Naʼashǫ́ʼii diwozhígíí	Smaug giganteus
Chʼóyáázh nahalinígíí (táłtłʼááh chʼosh)	Spirobranchus giganteus
Naatsédlózii	Geococcyx
Tʼááłáhági átʼéego:Bidił daazdoígíí dóó daʼałtʼoʼígíí	Categoria:Mammiferi
Tʼááłáhági átʼéego:Naaldlooshii dadichʼízhii	Categoria:Rettili
Tʼááłáhági átʼéego:Biyáázh Tsʼǫʼasánígíí	Categoria:Anfibi
Tʼááłáhági átʼéego:Tsídii	Categoria:Uccelli
Tʼááłáhági átʼéego:Chʼosh doo yitʼíinii dláádí dóó Ábishjaaʼ	Categoria:Fungi
Tʼááłáhági átʼéego:Chʼil	Categoria:Piante
Tʼááłáhági átʼéego:Nátʼą́ą́ʼ náháneʼ	Categoria:Storia
Tʼááłáhági átʼéego:Naʼalkaah	Categoria:Scienza
Tsétaʼkin	San Ildefonso Pueblo
Góóhníinii	Havasupai
Azeeʼ ndootʼeezhítsoh	Monarda fistulosa
Tsísʼná disxǫsígíí	Euglossini
Łóóʼtsoh bizábąąh shiyishí	Eubalaena
Tʼiis Názbąs	Teec Nos Pos
Kiisʼáanii Naakáí yikʼéʼ daʼdéísdlį́į́h	Rivolta Pueblo
Tsin bizęęs	Polyporus
Tó hájiiloh	Santo Domingo Pueblo
Naashashí (Yootó Hahoodzo)	Santa Clara Pueblo
Táłtłʼááh chʼosh chʼééh digháhii bikeeʼ nteelígíí	Naticidae
Aniłtʼánii łibáhígíí	Nabidae
Wóótsʼóóz	Alydidae
Jádító	Jeddito
Iichʼąhii	Falena
Chʼoshtsoh yázhí bíláshgaantsohí	Galatheidae
Roman dinéʼiʼ	Civiltà romana
Naadą́ą́ʼ bichʼosh	Diabrotica virgifera virgifera
Dlodziłgai bichʼil	Ipomopsis aggregata
Azeeʼ ndootʼeezhí	Monarda punctata
Dziłíjiin	Black Mesa (Arizona)
Naabeehó	Riserva Navajo
Chʼosh ałchozhii (iichʼąhii)	Tarma
Wóóchį́į́hnézí	Fulgoridae
Anaashashi dinéʼiʼ	Tewa
Tʼááłáhági átʼéego:Ałtsʼáʼáztiin	Categoria:Pagine di disambiguazione
Tsintah bįįhchilí	Tragulus
Tʼiistsʼóóz	Populus angustifolia
Naatʼáanii Nééz	Shiprock
Juan de Oñate	Juan de Oñate
Hastiin Antonio de Espejo	Antonio de Espejo
Gad diltáłii	Juniperus deppeana
Tsʼah	Artemisia tridentata
Tłʼoh Łikizhí	Tesuque Pueblo
Dibé łizhiní dinéʼiʼ	San Felipe Pueblo
Dził Łigaii (Dibé Nitsaa Hahoodzo)	Montagne San Juan
Tʼiistsʼóóz Ńdeeshgizh	Crownpoint
Naashtʼézhí (Yootó Hahoodzo)	Zuni Pueblo
Tséchʼil	Quercus gambelii
Ndilnaʼii	Folivora
Tsísʼnáyázhí	Halictidae
Oozéí Hayázhí	Moenkopi
Bíina	Ignacio
Tsé Dootłʼizh (Hoozdoh Hahoodzo)	Peridot (Arizona)
Dą́ʼáchaan	Ustilago
Wóláchííʼ azeeʼ	Dyssodia
Nátʼoh Dził	Altopiano del Kaibab
Kin Dootłʼizhí	Towaoc
Wóótʼą́hí	Aradidae
Woodiniih azeeʼ (chʼil)	Thelesperma
Íijeehí	Lappula
Biʼééʼ dootłʼizhgo disxǫsígíí	Pharomachrus
Tʼááłáhági átʼéego:Stubs	Categoria:Stub
Tʼááłáhági átʼéego:Chidí naatʼaʼí	Categoria:Aeromobili
Bee álnééhí:User uk-2	Template:Utente uk-2
Kin Łichííʼ (Yootó Hahoodzo)	San Juan Pueblo
Tó bichʼosh (dichʼízhígíí)	Gelastocoridae
Chʼóshgai (dził)	Montagne Chuska
Tónteel zhį́ʼii	Phalacrocoracidae
Niłtsínii bikétłʼóól dijoolí (daadánígíí)	Brassica rapa rapa
Tsídii bitseeʼ naashchʼąąʼí	Pavo
Bee álnééhí:Tl	Template:Tl
Tʼááłáhági átʼéego:Bee Hazʼáanii	Categoria:Diritto
Tʼááłáhági átʼéego:Kéyah daʼnaaznilígíí dóó kéyah biłhaʼdaʼhaasdzoígíí	Categoria:Nazioni
Wikiibíídiiya:Dahwéetʼaahígíí	Wikipedia:Amministratori
Wikiibíídiiya:Botígíí beehazʼą́ąnii	Wikipedia:Bot
Ííjip	Egitto
Bee álnééhí:Bot	Template:Bot
Deeteel Bikéyah	Canada
Wikiibíídiiya:Baa haneʼ	Wikipedia:Sala stampa/Wikipedia
Tʼááłáhági átʼéego:Béésh bichʼahníí bikéyah	Categoria:Stati dell'Europa
Tʼááłáhági átʼéego:Choyoołʼįįhí Bizaad	Categoria:Utenti per lingua
Anáʼálwoʼ:Wikiibíídiiya beehazʼą́ąnii	Wikipedia:Raccomandazioni e linee guida
Tséłnííʼjí (chʼil)	Adiantum capillus-veneris
Bee álnééhí:Softredirect	Template:Soft redirect
Chʼosh chʼééh digháhii	Gastropoda
Tʼááłáhági átʼéego:Saad	Categoria:Lingue
Wikiibíídiiya:General disclaimer	Wikipedia:Avvertenze generali
Tʼááłáhági átʼéego:Noindexed pages	Categoria:Pagine non indicizzate
Tʼááłáhági átʼéego:Living people	Categoria:Persone viventi
Tʼááłáhági átʼéego:Béésh bee akʼeʼelchíhí tʼáá bí nitsékeesígíí	Categoria:Applicazioni dell'informatica
Bee álnééhí:Bots	Template:Bots
Tʼááłáhági átʼéego:Naaltsoos	Categoria:Libro
Bee álnééhí:Wikisource	Template:Wikisource
Bee álnééhí:Babel	Template:Babel
Bee álnééhí:Commons	Template:Commons
Bee álnééhí:Reflist	Template:References
Tábąąh mąʼii bíchį́į́h nineezí	Coati
Bee álnééhí:Stub	Template:S
Bee álnééhí:User af-1	Template:Utente af-1
Bee álnééhí:User als-1	Template:Utente als-1
Bee álnééhí:User ar-1	Template:Utente ar-1
Bee álnééhí:User az	Template:Utente az
Bee álnééhí:User eo-1	Template:Utente eo-1
Bee álnééhí:See also	Template:Vedi anche
Bee álnééhí:User da-2	Template:Utente da-2
Bee álnééhí:User da	Template:Utente da
Bee álnééhí:User ca-1	Template:Utente ca-1
Bee álnééhí:User be-2	Template:Utente be-2
Bee álnééhí:User da-1	Template:Utente da-1
Bee álnééhí:User cs-1	Template:Utente cs-1
Bee álnééhí:User bg-1	Template:Utente bg-1
Bee álnééhí:User eo-3	Template:Utente eo-3
Bee álnééhí:User de	Template:Utente de
Bee álnééhí:User de-1	Template:Utente de-1
Bee álnééhí:User eu-4	Template:Utente eu-4
Bee álnééhí:User eu	Template:Utente eu
Bee álnééhí:User et-1	Template:Utente et-1
Bee álnééhí:User el	Template:Utente el
Bee álnééhí:User es	Template:Utente es
Bee álnééhí:User de-3	Template:Utente de-3
Bee álnééhí:User en-3	Template:Utente en-3
Bee álnééhí:User el-1	Template:Utente el-1
Bee álnééhí:User en-1	Template:Utente en-1
Bee álnééhí:User en-2	Template:Utente en-2
Bee álnééhí:User eo-2	Template:Utente eo-2
Bee álnééhí:User en-4	Template:Utente en-4
Bee álnééhí:User fi	Template:Utente fi
Bee álnééhí:User en-0	Template:Utente en-0
Bee álnééhí:User es-4	Template:Utente es-4
Bee álnééhí:User en	Template:Utente en
Bee álnééhí:User de-2	Template:Utente de-2
Bee álnééhí:User es-1	Template:Utente es-1
Bee álnééhí:User fa	Template:Utente fa
Bee álnééhí:User fi-1	Template:Utente fi-1
Bee álnééhí:User fr-1	Template:Utente fr-1
Bee álnééhí:User ia-2	Template:Utente ia-2
Bee álnééhí:User hi-1	Template:Utente hi-1
Bee álnééhí:User hr	Template:Utente hr
Bee álnééhí:User he-2	Template:Utente he-2
Bee álnééhí:User he-1	Template:Utente he-1
Bee álnééhí:User hu	Template:Utente hu
Bee álnééhí:User id-3	Template:Utente id-3
Bee álnééhí:User io-3	Template:Utente io-3
Bee álnééhí:User it-3	Template:Utente it-3
Bee álnééhí:User grc-1	Template:Utente grc-1
Bee álnééhí:User ja-4	Template:Utente ja-4
Bee álnééhí:User sk	Template:Utente sk
Bee álnééhí:User tr-2	Template:Utente tr-2
Bee álnééhí:User fr-2	Template:Utente fr-2
Bee álnééhí:User tr	Template:Utente tr
Bee álnééhí:User ja	Template:Utente ja
Bee álnééhí:User ja-1	Template:Utente ja-1
Bee álnééhí:User it-1	Template:Utente it-1
Bee álnééhí:User hr-1	Template:Utente hr-1
Bee álnééhí:User fr	Template:Utente fr
Bee álnééhí:User he	Template:Utente he
Tʼááłáhági átʼéego:Chʼosh bijáád hastánígíí	Categoria:Insetti
Tʼááłáhági átʼéego:Choyoołʼįįhí uk	Categoria:Utenti uk
Tʼááłáhági átʼéego:Choyoołʼįįhí uk-N	Categoria:Utenti uk-M
Tʼááłáhági átʼéego:Chʼiyáán	Categoria:Alimenti
Bee álnééhí:User sv	Template:Utente sv
Bee álnééhí:User it	Template:Utente it
Bee álnééhí:User uk	Template:Utente uk
Bee álnééhí:User es-2	Template:Utente es-2
Tʼááłáhági átʼéego:Choyoołʼįįhí ms	Categoria:Utenti ms
Tʼááłáhági átʼéego:Choyoołʼįįhí fr-1	Categoria:Utenti fr-1
Bee álnééhí:Image label	Template:Etichetta immagine
Bee álnééhí:User ms	Template:Utente ms
Tʼááłáhági átʼéego:Atsá dóó Giní Ndahalinígíí	Categoria:Falconiformes
Tʼááłáhági átʼéego:Choyoołʼįįhí en-4	Categoria:Utenti en-4
Tʼááłáhági átʼéego:Choyoołʼįįhí en	Categoria:Utenti en
Tʼááłáhági átʼéego:Choyoołʼįįhí zh	Categoria:Utenti zh
Tʼááłáhági átʼéego:Choyoołʼįįhí zh-N	Categoria:Utenti zh-M
Tʼááłáhági átʼéego:Choyoołʼįįhí en-2	Categoria:Utenti en-2
Bee álnééhí:User eo	Template:Utente eo
Bee álnééhí:User zh	Template:Utente zh
Bee álnééhí:User ru-4	Template:Utente ru-4
Bee álnééhí:User sr	Template:Utente sr
Bee álnééhí:GeoTemplate	Template:GeoTemplate
Bee álnééhí:User nl-1	Template:Utente nl-1
Bee álnééhí:User nl-2	Template:Utente nl-2
Tʼááłáhági átʼéego:Choyoołʼįįhí hi	Categoria:Utenti hi
Tʼááłáhági átʼéego:Choyoołʼįįhí ms-N	Categoria:Utenti ms-M
Tʼááłáhági átʼéego:Dził	Categoria:Montagne
Bee álnééhí:User ru	Template:Utente ru
Tʼááłáhági átʼéego:Kéyah yádiłhił biiʼ dahólónígíí	Categoria:Pianeti del sistema solare
Tʼááłáhági átʼéego:Kéyah dah siʼánígíí	Categoria:America
Tʼááłáhági átʼéego:Choyoołʼįįhí bizaad-Templates	Categoria:Template Babel
Bee álnééhí:Archive	Template:Archivio
Bee álnééhí:User eo-4	Template:Utente eo-4
Bee álnééhí:PD-US-gov	Template:PD-USGov
Tʼááłáhági átʼéego:Siláołtsooí	Categoria:Forze armate
Tʼááłáhági átʼéego:Naʼashǫ́ʼii	Categoria:Sauri
Bee álnééhí:User pt-1	Template:Utente pt-1
Bee álnééhí:Pt elements	Template:Tavola periodica
Bee álnééhí:User pl	Template:Utente pl
Bee álnééhí:User nl	Template:Utente nl
Bee álnééhí:User no-2	Template:Utente no-2
Bee álnééhí:Image label end	Template:Etichetta immagine fine
Bee álnééhí:Userpage	Template:Pagina utente
Bee álnééhí:Emergency-bot-shutoff	Template:Pulsante di emergenza bot
Bee álnééhí:User pl-1	Template:Utente pl-1
Bee álnééhí:Image label small	Template:Etichetta immagine piccola
Bee álnééhí:User fr-3	Template:Utente fr-3
Bee álnééhí:User lt	Template:Utente lt
Bee álnééhí:User nds-1	Template:Utente nds-1
Tʼááłáhági átʼéego:Hosh	Categoria:Cactaceae
Bee álnééhí:User tr-4	Template:Utente tr-4
Bee álnééhí:User ar-2	Template:Utente ar-2
Bee álnééhí:User ar-3	Template:Utente ar-3
Bee álnééhí:User ar	Template:Utente ar
Bee álnééhí:User az-3	Template:Utente az-3
Bee álnééhí:User en-5	Template:Utente en-5
Tʼááłáhági átʼéego:Choyoołʼįįhí ja-N	Categoria:Utenti ja-M
Bee álnééhí:User als	Template:Utente als
Bee álnééhí:@	Template:@
Tʼááłáhági átʼéego:Tłʼoh	Categoria:Poaceae
Bee álnééhí:Ałtsʼáʼáztiin	Template:Disambigua
Bee álnééhí:User no	Template:Utente no
Bee álnééhí:Chʼiyáánbiiʼ	Template:Valori nutrizionali
Bee álnééhí:User sv-2	Template:Utente sv-2
Bee álnééhí:User it-2	Template:Utente it-2
Tʼááłáhági átʼéego:Ásáí Bikéyah	Categoria:Paesi membri della Lega Araba
Tʼááłáhági átʼéego:Kǫʼ naʼałbąąsii	Categoria:Ferrovie
Bee álnééhí:User pt-2	Template:Utente pt-2
Bee álnééhí:User lb-1	Template:Utente lb-1
Bee álnééhí:User fr-4	Template:Utente fr-4
Bee álnééhí:User bg	Template:Utente bg
Tʼááłáhági átʼéego:Choyoołʼįįhí vi-3	Categoria:Utenti vi-3
Bee álnééhí:User la-1	Template:Utente la-1
Tʼááłáhági átʼéego:Templates/doc	Categoria:Manuali dei template
Tʼááłáhági átʼéego:Choyoołʼįįhí yue	Categoria:Utenti yue
Tʼááłáhági átʼéego:Choyoołʼįįhí mzn	Categoria:Utenti mzn
Tʼááłáhági átʼéego:Choyoołʼįįhí at	Categoria:Utenti de-at
Tʼááłáhági átʼéego:Choyoołʼįįhí az	Categoria:Utenti az
Tʼááłáhági átʼéego:Choyoołʼįįhí be	Categoria:Utenti be
Tʼááłáhági átʼéego:Choyoołʼįįhí bs	Categoria:Utenti bs
Tʼááłáhági átʼéego:Choyoołʼįįhí hr	Categoria:Utenti hr
Tʼááłáhági átʼéego:Choyoołʼįįhí sk	Categoria:Utenti sk
Tʼááłáhági átʼéego:Choyoołʼįįhí sl	Categoria:Utenti sl
Tʼááłáhági átʼéego:Choyoołʼįįhí eo	Categoria:Utenti eo
Tʼááłáhági átʼéego:Choyoołʼįįhí et	Categoria:Utenti et
Tʼááłáhági átʼéego:Choyoołʼįįhí fr	Categoria:Utenti fr
Tʼááłáhági átʼéego:Choyoołʼįįhí gl	Categoria:Utenti gl
Tʼááłáhági átʼéego:Choyoołʼįįhí cy	Categoria:Utenti cy
Tʼááłáhági átʼéego:Choyoołʼįįhí hu-N	Categoria:Utenti hu-M
Tʼááłáhági átʼéego:Choyoołʼįįhí id	Categoria:Utenti id
Tʼááłáhági átʼéego:Choyoołʼįįhí ia	Categoria:Utenti ia
Tʼááłáhági átʼéego:Choyoołʼįįhí ga	Categoria:Utenti ga
Tʼááłáhági átʼéego:Choyoołʼįįhí ja	Categoria:Utenti ja
Tʼááłáhági átʼéego:Choyoołʼįįhí km	Categoria:Utenti km
Tʼááłáhági átʼéego:Choyoołʼįįhí rn	Categoria:Utenti rn
Tʼááłáhági átʼéego:Choyoołʼįįhí la	Categoria:Utenti la
Tʼááłáhági átʼéego:Choyoołʼįįhí li	Categoria:Utenti li
Tʼááłáhági átʼéego:Choyoołʼįįhí lt	Categoria:Utenti lt
Tʼááłáhági átʼéego:Choyoołʼįįhí mk	Categoria:Utenti mk
Tʼááłáhági átʼéego:Choyoołʼįįhí mg	Categoria:Utenti mg
Tʼááłáhági átʼéego:Choyoołʼįįhí mwl	Categoria:Utenti mwl
Tʼááłáhági átʼéego:Choyoołʼįįhí mn	Categoria:Utenti mn
Tʼááłáhági átʼéego:Choyoołʼįįhí nn	Categoria:Utenti nn
Tʼááłáhági átʼéego:Choyoołʼįįhí nah	Categoria:Utenti nah
Tʼááłáhági átʼéego:Choyoołʼįįhí oc	Categoria:Utenti oc
Tʼááłáhági átʼéego:Choyoołʼįįhí pt	Categoria:Utenti pt
Tʼááłáhági átʼéego:Choyoołʼįįhí ro	Categoria:Utenti ro
Tʼááłáhági átʼéego:Choyoołʼįįhí sc	Categoria:Utenti sc
Tʼááłáhági átʼéego:Choyoołʼįįhí sh	Categoria:Utenti sh
Tʼááłáhági átʼéego:Choyoołʼįįhí sv	Categoria:Utenti sv
Tʼááłáhági átʼéego:Choyoołʼįįhí sw	Categoria:Utenti sw
Tʼááłáhági átʼéego:Choyoołʼįįhí sa	Categoria:Utenti sa
Tʼááłáhági átʼéego:Choyoołʼįįhí th	Categoria:Utenti th
Tʼááłáhági átʼéego:Choyoołʼįįhí ta	Categoria:Utenti ta
Tʼááłáhági átʼéego:Choyoołʼįįhí vo	Categoria:Utenti vo
Tʼááłáhági átʼéego:Choyoołʼįįhí az-3	Categoria:Utenti az-3
Tʼááłáhági átʼéego:Choyoołʼįįhí be-3	Categoria:Utenti be-3
Tʼááłáhági átʼéego:Choyoołʼįįhí cs-3	Categoria:Utenti cs-3
Tʼááłáhági átʼéego:Choyoołʼįįhí sl-3	Categoria:Utenti sl-3
Tʼááłáhági átʼéego:Choyoołʼįįhí et-3	Categoria:Utenti et-3
Tʼááłáhági átʼéego:Choyoołʼįįhí fr-3	Categoria:Utenti fr-3
Tʼááłáhági átʼéego:Choyoołʼįįhí cy-3	Categoria:Utenti cy-3
Tʼááłáhági átʼéego:Choyoołʼįįhí hi-3	Categoria:Utenti hi-3
Tʼááłáhági átʼéego:Choyoołʼįįhí it-3	Categoria:Utenti it-3
Tʼááłáhági átʼéego:Choyoołʼįįhí ja-3	Categoria:Utenti ja-3
Tʼááłáhági átʼéego:Choyoołʼįįhí li-3	Categoria:Utenti li-3
Tʼááłáhági átʼéego:Choyoołʼįįhí lt-3	Categoria:Utenti lt-3
Tʼááłáhági átʼéego:Choyoołʼįįhí mk-3	Categoria:Utenti mk-3
Tʼááłáhági átʼéego:Choyoołʼįįhí nl-3	Categoria:Utenti nl-3
Tʼááłáhági átʼéego:Choyoołʼįįhí no-3	Categoria:Utenti no-3
Tʼááłáhági átʼéego:Choyoołʼįįhí oc-3	Categoria:Utenti oc-3
Tʼááłáhági átʼéego:Choyoołʼįįhí pl-3	Categoria:Utenti pl-3
Tʼááłáhági átʼéego:Choyoołʼįįhí sw-3	Categoria:Utenti sw-3
Tʼááłáhági átʼéego:Choyoołʼįįhí tr-3	Categoria:Utenti tr-3
Tʼááłáhági átʼéego:Choyoołʼįįhí ar-3	Categoria:Utenti ar-3
Tʼááłáhági átʼéego:Choyoołʼįįhí an-1	Categoria:Utenti an-1
Tʼááłáhági átʼéego:Choyoołʼįįhí be-1	Categoria:Utenti be-1
Tʼááłáhági átʼéego:Choyoołʼįįhí cs-1	Categoria:Utenti cs-1
Tʼááłáhági átʼéego:Choyoołʼįįhí da-1	Categoria:Utenti da-1
Tʼááłáhági átʼéego:Choyoołʼįįhí sl-1	Categoria:Utenti sl-1
Tʼááłáhági átʼéego:Choyoołʼįįhí et-1	Categoria:Utenti et-1
Tʼááłáhági átʼéego:Choyoołʼįįhí fi-1	Categoria:Utenti fi-1
Tʼááłáhági átʼéego:Choyoołʼįįhí cy-1	Categoria:Utenti cy-1
Tʼááłáhági átʼéego:Choyoołʼįįhí hi-1	Categoria:Utenti hi-1
Tʼááłáhági átʼéego:Choyoołʼįįhí ia-1	Categoria:Utenti ia-1
Tʼááłáhági átʼéego:Choyoołʼįįhí ga-1	Categoria:Utenti ga-1
Tʼááłáhági átʼéego:Choyoołʼįįhí jv-1	Categoria:Utenti jv-1
Tʼááłáhági átʼéego:Choyoołʼįįhí ku-1	Categoria:Utenti ku-1
Tʼááłáhági átʼéego:Choyoołʼįįhí lv-1	Categoria:Utenti lv-1
Tʼááłáhági átʼéego:Choyoołʼįįhí li-1	Categoria:Utenti li-1
Tʼááłáhági átʼéego:Choyoołʼįįhí lt-1	Categoria:Utenti lt-1
Tʼááłáhági átʼéego:Choyoołʼįįhí mk-1	Categoria:Utenti mk-1
Tʼááłáhági átʼéego:Choyoołʼįįhí nl-1	Categoria:Utenti nl-1
Tʼááłáhági átʼéego:Choyoołʼįįhí oc-1	Categoria:Utenti oc-1
Tʼááłáhági átʼéego:Choyoołʼįįhí pl-1	Categoria:Utenti pl-1
Tʼááłáhági átʼéego:Choyoołʼįįhí ro-1	Categoria:Utenti ro-1
Tʼááłáhági átʼéego:Choyoołʼįįhí sc-1	Categoria:Utenti sc-1
Tʼááłáhági átʼéego:Choyoołʼįįhí sh-1	Categoria:Utenti sh-1
Tʼááłáhági átʼéego:Choyoołʼįįhí sw-1	Categoria:Utenti sw-1
Tʼááłáhági átʼéego:Choyoołʼįįhí sa-1	Categoria:Utenti sa-1
Tʼááłáhági átʼéego:Choyoołʼįįhí tr-1	Categoria:Utenti tr-1
Tʼááłáhági átʼéego:Choyoołʼįįhí vo-1	Categoria:Utenti vo-1
Tʼááłáhági átʼéego:Choyoołʼįįhí ar-1	Categoria:Utenti ar-1
Tʼááłáhági átʼéego:Choyoołʼįįhí sl-4	Categoria:Utenti sl-4
Tʼááłáhági átʼéego:Choyoołʼįįhí et-4	Categoria:Utenti et-4
Tʼááłáhági átʼéego:Choyoołʼįįhí fr-4	Categoria:Utenti fr-4
Tʼááłáhági átʼéego:Choyoołʼįįhí hu-4	Categoria:Utenti hu-4
Tʼááłáhági átʼéego:Choyoołʼįįhí it-4	Categoria:Utenti it-4
Tʼááłáhági átʼéego:Choyoołʼįįhí li-4	Categoria:Utenti li-4
Tʼááłáhági átʼéego:Choyoołʼįįhí oc-4	Categoria:Utenti oc-4
Tʼááłáhági átʼéego:Choyoołʼįįhí pl-4	Categoria:Utenti pl-4
Tʼááłáhági átʼéego:Choyoołʼįįhí sw-4	Categoria:Utenti sw-4
Tʼááłáhági átʼéego:Choyoołʼįįhí als-2	Categoria:Utenti als-2
Tʼááłáhági átʼéego:Choyoołʼįįhí mzn-2	Categoria:Utenti mzn-2
Tʼááłáhági átʼéego:Choyoołʼįįhí be-2	Categoria:Utenti be-2
Tʼááłáhági átʼéego:Choyoołʼįįhí bs-2	Categoria:Utenti bs-2
Tʼááłáhági átʼéego:Choyoołʼįįhí cs-2	Categoria:Utenti cs-2
Tʼááłáhági átʼéego:Choyoołʼįįhí da-2	Categoria:Utenti da-2
Tʼááłáhági átʼéego:Choyoołʼįįhí sk-2	Categoria:Utenti sk-2
Tʼááłáhági átʼéego:Choyoołʼįįhí sl-2	Categoria:Utenti sl-2
Tʼááłáhági átʼéego:Choyoołʼįįhí et-2	Categoria:Utenti et-2
Tʼááłáhági átʼéego:Choyoołʼįįhí fr-2	Categoria:Utenti fr-2
Tʼááłáhági átʼéego:Choyoołʼįįhí cy-2	Categoria:Utenti cy-2
Tʼááłáhági átʼéego:Choyoołʼįįhí hi-2	Categoria:Utenti hi-2
Tʼááłáhági átʼéego:Choyoołʼįįhí hu-2	Categoria:Utenti hu-2
Tʼááłáhági átʼéego:Choyoołʼįįhí ia-2	Categoria:Utenti ia-2
Tʼááłáhági átʼéego:Choyoołʼįįhí it-2	Categoria:Utenti it-2
Tʼááłáhági átʼéego:Choyoołʼįįhí ja-2	Categoria:Utenti ja-2
Tʼááłáhági átʼéego:Choyoołʼįįhí la-2	Categoria:Utenti la-2
Tʼááłáhági átʼéego:Choyoołʼįįhí li-2	Categoria:Utenti li-2
Tʼááłáhági átʼéego:Choyoołʼįįhí lt-2	Categoria:Utenti lt-2
Tʼááłáhági átʼéego:Choyoołʼįįhí mk-2	Categoria:Utenti mk-2
Tʼááłáhági átʼéego:Choyoołʼįįhí mwl-2	Categoria:Utenti mwl-2
Tʼááłáhági átʼéego:Choyoołʼįįhí nl-2	Categoria:Utenti nl-2
Tʼááłáhági átʼéego:Choyoołʼįįhí oc-2	Categoria:Utenti oc-2
Tʼááłáhági átʼéego:Choyoołʼįįhí pl-2	Categoria:Utenti pl-2
Tʼááłáhági átʼéego:Choyoołʼįįhí sh-2	Categoria:Utenti sh-2
Tʼááłáhági átʼéego:Choyoołʼįįhí sv-2	Categoria:Utenti sv-2
Tʼááłáhági átʼéego:Choyoołʼįįhí sw-2	Categoria:Utenti sw-2
Tʼááłáhági átʼéego:Choyoołʼįįhí sa-2	Categoria:Utenti sa-2
Tʼááłáhági átʼéego:Choyoołʼįįhí tr-2	Categoria:Utenti tr-2
Tʼááłáhági átʼéego:Choyoołʼįįhí ar-2	Categoria:Utenti ar-2
Tʼááłáhági átʼéego:Choyoołʼįįhí at-N	Categoria:Utenti de-at-M
Tʼááłáhági átʼéego:Choyoołʼįįhí an-N	Categoria:Utenti an-M
Tʼááłáhági átʼéego:Choyoołʼįįhí ast-N	Categoria:Utenti ast-M
Tʼááłáhági átʼéego:Choyoołʼįįhí be-N	Categoria:Utenti be-M
Tʼááłáhági átʼéego:Choyoołʼįįhí cs-N	Categoria:Utenti cs-M
Tʼááłáhági átʼéego:Choyoołʼįįhí ko-N	Categoria:Utenti ko-M
Tʼááłáhági átʼéego:Choyoołʼįįhí hr-N	Categoria:Utenti hr-M
Tʼááłáhági átʼéego:Choyoołʼįįhí sl-N	Categoria:Utenti sl-M
Tʼááłáhági átʼéego:Choyoołʼįįhí et-N	Categoria:Utenti et-M
Tʼááłáhági átʼéego:Choyoołʼįįhí fr-N	Categoria:Utenti fr-M
Tʼááłáhági átʼéego:Choyoołʼįįhí fy-N	Categoria:Utenti fy-M
Tʼááłáhági átʼéego:Choyoołʼįįhí gl-N	Categoria:Utenti gl-M
Tʼááłáhági átʼéego:Choyoołʼįįhí cy-N	Categoria:Utenti cy-M
Tʼááłáhági átʼéego:Choyoołʼįįhí hi-N	Categoria:Utenti hi-M
Tʼááłáhági átʼéego:Choyoołʼįįhí id-N	Categoria:Utenti id-M
Tʼááłáhági átʼéego:Choyoołʼįįhí is-N	Categoria:Utenti is-M
Tʼááłáhági átʼéego:Choyoołʼįįhí it-N	Categoria:Utenti it-M
Tʼááłáhági átʼéego:Choyoołʼįįhí jv-N	Categoria:Utenti jv-M
Tʼááłáhági átʼéego:Choyoołʼįįhí ku-N	Categoria:Utenti ku-M
Tʼááłáhági átʼéego:Choyoołʼįįhí lv-N	Categoria:Utenti lv-M
Tʼááłáhági átʼéego:Choyoołʼįįhí li-N	Categoria:Utenti li-M
Tʼááłáhági átʼéego:Choyoołʼįįhí lt-N	Categoria:Utenti lt-M
Tʼááłáhági átʼéego:Choyoołʼįįhí lb-N	Categoria:Utenti lb-M
Tʼááłáhági átʼéego:Choyoołʼįįhí mk-N	Categoria:Utenti mk-M
Tʼááłáhági átʼéego:Choyoołʼįįhí mg-N	Categoria:Utenti mg-M
Tʼááłáhági átʼéego:Choyoołʼįįhí nl-N	Categoria:Utenti nl-M
Tʼááłáhági átʼéego:Choyoołʼįįhí no-N	Categoria:Utenti no-M
Tʼááłáhági átʼéego:Choyoołʼįįhí nn-N	Categoria:Utenti nn-M
Tʼááłáhági átʼéego:Choyoołʼįįhí nah-N	Categoria:Utenti nah-M
Tʼááłáhági átʼéego:Choyoołʼįįhí oc-N	Categoria:Utenti oc-M
Tʼááłáhági átʼéego:Choyoołʼįįhí or-N	Categoria:Utenti or-M
Tʼááłáhági átʼéego:Choyoołʼįįhí ru-N	Categoria:Utenti ru-M
Tʼááłáhági átʼéego:Choyoołʼįįhí sh-N	Categoria:Utenti sh-M
Tʼááłáhági átʼéego:Choyoołʼįįhí sw-N	Categoria:Utenti sw-M
Tʼááłáhági átʼéego:Choyoołʼįįhí ta-N	Categoria:Utenti ta-M
Tʼááłáhági átʼéego:Choyoołʼįįhí ar-N	Categoria:Utenti ar-M
Tʼááłáhági átʼéego:Choyoołʼįįhí eu-3	Categoria:Utenti eu-3
Tʼááłáhági átʼéego:Choyoołʼįįhí eu-N	Categoria:Utenti eu-M
Tʼááłáhági átʼéego:Choyoołʼįįhí af	Categoria:Utenti af
Tʼááłáhági átʼéego:Choyoołʼįįhí af-1	Categoria:Utenti af-1
Tʼááłáhági átʼéego:Choyoołʼįįhí af-2	Categoria:Utenti af-2
Tʼááłáhági átʼéego:Choyoołʼįįhí af-3	Categoria:Utenti af-3
Tʼááłáhági átʼéego:Choyoołʼįįhí af-N	Categoria:Utenti af-M
Tʼááłáhági átʼéego:Choyoołʼįįhí als	Categoria:Utenti als
Tʼááłáhági átʼéego:Choyoołʼįįhí als-1	Categoria:Utenti als-1
Tʼááłáhági átʼéego:Choyoołʼįįhí an	Categoria:Utenti an
Tʼááłáhági átʼéego:Choyoołʼįįhí ar	Categoria:Utenti ar
Tʼááłáhági átʼéego:Choyoołʼįįhí ast	Categoria:Utenti ast
Tʼááłáhági átʼéego:Choyoołʼįįhí ay	Categoria:Utenti ay
Tʼááłáhági átʼéego:Choyoołʼįįhí ay-4	Categoria:Utenti ay-4
Tʼááłáhági átʼéego:Choyoołʼįįhí az-1	Categoria:Utenti az-1
Tʼááłáhági átʼéego:Choyoołʼįįhí az-2	Categoria:Utenti az-2
Tʼááłáhági átʼéego:Choyoołʼįįhí az-N	Categoria:Utenti az-M
Tʼááłáhági átʼéego:Choyoołʼįįhí ba	Categoria:Utenti ba
Tʼááłáhági átʼéego:Choyoołʼįįhí bar	Categoria:Utenti bar
Tʼááłáhági átʼéego:Choyoołʼįįhí bar-N	Categoria:Utenti bar-M
Tʼááłáhági átʼéego:Choyoołʼįįhí bg	Categoria:Utenti bg
Tʼááłáhági átʼéego:Choyoołʼįįhí bg-1	Categoria:Utenti bg-1
Tʼááłáhági átʼéego:Choyoołʼįįhí bg-2	Categoria:Utenti bg-2
Tʼááłáhági átʼéego:Choyoołʼįįhí bg-3	Categoria:Utenti bg-3
Tʼááłáhági átʼéego:Choyoołʼįįhí bg-N	Categoria:Utenti bg-M
Tʼááłáhági átʼéego:Choyoołʼįįhí bn	Categoria:Utenti bn
Tʼááłáhági átʼéego:Choyoołʼįįhí bn-2	Categoria:Utenti bn-2
Tʼááłáhági átʼéego:Choyoołʼįįhí bn-N	Categoria:Utenti bn-M
Tʼááłáhági átʼéego:Choyoołʼįįhí ca	Categoria:Utenti ca
Tʼááłáhági átʼéego:Choyoołʼįįhí ca-1	Categoria:Utenti ca-1
Tʼááłáhági átʼéego:Choyoołʼįįhí ca-2	Categoria:Utenti ca-2
Tʼááłáhági átʼéego:Tádídíín deiyání	Categoria:Chrysomelidae
Tʼááłáhági átʼéego:Choyoołʼįįhí ca-3	Categoria:Utenti ca-3
Tʼááłáhági átʼéego:Choyoołʼįįhí ca-N	Categoria:Utenti ca-M
Tʼááłáhági átʼéego:Choyoołʼįįhí cs	Categoria:Utenti cs
Tʼááłáhági átʼéego:Choyoołʼįįhí da	Categoria:Utenti da
Tʼááłáhági átʼéego:Choyoołʼįįhí sk-N	Categoria:Utenti sk-M
Tʼááłáhági átʼéego:Choyoołʼįįhí da-3	Categoria:Utenti da-3
Tʼááłáhági átʼéego:Choyoołʼįįhí de	Categoria:Utenti de
Tʼááłáhági átʼéego:Choyoołʼįįhí de-2	Categoria:Utenti de-2
Tʼááłáhági átʼéego:Choyoołʼįįhí de-3	Categoria:Utenti de-3
Tʼááłáhági átʼéego:Choyoołʼįįhí de-4	Categoria:Utenti de-4
Tʼááłáhági átʼéego:Choyoołʼįįhí de-N	Categoria:Utenti de-M
Tʼááłáhági átʼéego:Choyoołʼįįhí dsb	Categoria:Utenti dsb
Tʼááłáhági átʼéego:Choyoołʼįįhí dsb-1	Categoria:Utenti dsb-1
Tʼááłáhági átʼéego:Choyoołʼįįhí dsb-2	Categoria:Utenti dsb-2
Tʼááłáhági átʼéego:Choyoołʼįįhí dsb-N	Categoria:Utenti dsb-M
Tʼááłáhági átʼéego:Choyoołʼįįhí el	Categoria:Utenti el
Tʼááłáhági átʼéego:Choyoołʼįįhí el-1	Categoria:Utenti el-1
Tʼááłáhági átʼéego:Choyoołʼįįhí el-2	Categoria:Utenti el-2
Tʼááłáhági átʼéego:Choyoołʼįįhí el-3	Categoria:Utenti el-3
Tʼááłáhági átʼéego:Choyoołʼįįhí el-4	Categoria:Utenti el-4
Tʼááłáhági átʼéego:Choyoołʼįįhí el-N	Categoria:Utenti el-M
Tʼááłáhági átʼéego:Choyoołʼįįhí en-0	Categoria:Utenti en-0
Tʼááłáhági átʼéego:Choyoołʼįįhí en-3	Categoria:Utenti en-3
Tʼááłáhági átʼéego:Choyoołʼįįhí en-N	Categoria:Utenti en-M
Tʼááłáhági átʼéego:Choyoołʼįįhí eo-1	Categoria:Utenti eo-1
Tʼááłáhági átʼéego:Choyoołʼįįhí eo-2	Categoria:Utenti eo-2
Tʼááłáhági átʼéego:Choyoołʼįįhí eo-3	Categoria:Utenti eo-3
Tʼááłáhági átʼéego:Choyoołʼįįhí eo-4	Categoria:Utenti eo-4
Tʼááłáhági átʼéego:Choyoołʼįįhí eo-N	Categoria:Utenti eo-M
Tʼááłáhági átʼéego:Choyoołʼįįhí es	Categoria:Utenti es
Tʼááłáhági átʼéego:Choyoołʼįįhí es-1	Categoria:Utenti es-1
Tʼááłáhági átʼéego:Choyoołʼįįhí es-2	Categoria:Utenti es-2
Tʼááłáhági átʼéego:Choyoołʼįįhí es-3	Categoria:Utenti es-3
Tʼááłáhági átʼéego:Choyoołʼįįhí es-4	Categoria:Utenti es-4
Tʼááłáhági átʼéego:Choyoołʼįįhí es-N	Categoria:Utenti es-M
Tʼááłáhági átʼéego:Choyoołʼįįhí eu	Categoria:Utenti eu
Tʼááłáhági átʼéego:Choyoołʼįįhí eu-1	Categoria:Utenti eu-1
Tʼááłáhági átʼéego:Choyoołʼįįhí eu-2	Categoria:Utenti eu-2
Tʼááłáhági átʼéego:Choyoołʼįįhí eu-4	Categoria:Utenti eu-4
Tʼááłáhági átʼéego:Choyoołʼįįhí fa	Categoria:Utenti fa
Tʼááłáhági átʼéego:Choyoołʼįįhí fa-1	Categoria:Utenti fa-1
Tʼááłáhági átʼéego:Choyoołʼįįhí fa-2	Categoria:Utenti fa-2
Tʼááłáhági átʼéego:Choyoołʼįįhí fa-3	Categoria:Utenti fa-3
Tʼááłáhági átʼéego:Choyoołʼįįhí fa-N	Categoria:Utenti fa-M
Tʼááłáhági átʼéego:Choyoołʼįįhí fi	Categoria:Utenti fi
Tʼááłáhági átʼéego:Choyoołʼįįhí fi-2	Categoria:Utenti fi-2
Tʼááłáhági átʼéego:Choyoołʼįįhí fi-3	Categoria:Utenti fi-3
Tʼááłáhági átʼéego:Choyoołʼįįhí fi-4	Categoria:Utenti fi-4
Tʼááłáhági átʼéego:Choyoołʼįįhí fi-N	Categoria:Utenti fi-M
Tʼááłáhági átʼéego:Choyoołʼįįhí fy	Categoria:Utenti fy
Tʼááłáhági átʼéego:Choyoołʼįįhí fy-1	Categoria:Utenti fy-1
Tʼááłáhági átʼéego:Choyoołʼįįhí ga-2	Categoria:Utenti ga-2
Tʼááłáhági átʼéego:Choyoołʼįįhí ga-3	Categoria:Utenti ga-3
Tʼááłáhági átʼéego:Choyoołʼįįhí ga-N	Categoria:Utenti ga-M
Tʼááłáhági átʼéego:Choyoołʼįįhí grc	Categoria:Utenti grc
Tʼááłáhági átʼéego:Choyoołʼįįhí grc-1	Categoria:Utenti grc-1
Tʼááłáhági átʼéego:Choyoołʼįįhí grc-2	Categoria:Utenti grc-2
Tʼááłáhági átʼéego:Choyoołʼįįhí grc-3	Categoria:Utenti grc-3
Tʼááłáhági átʼéego:Choyoołʼįįhí gsw	Categoria:Utenti gsw
Tʼááłáhági átʼéego:Choyoołʼįįhí gsw-N	Categoria:Utenti gsw-M
Tʼááłáhági átʼéego:Choyoołʼįįhí he	Categoria:Utenti he
Tʼááłáhági átʼéego:Choyoołʼįįhí he-1	Categoria:Utenti he-1
Tʼááłáhági átʼéego:Choyoołʼįįhí he-2	Categoria:Utenti he-2
Tʼááłáhági átʼéego:Choyoołʼįįhí he-3	Categoria:Utenti he-3
Tʼááłáhági átʼéego:Choyoołʼįįhí he-4	Categoria:Utenti he-4
Tʼááłáhági átʼéego:Choyoołʼįįhí he-N	Categoria:Utenti he-M
Tʼááłáhági átʼéego:Choyoołʼįįhí hr-1	Categoria:Utenti hr-1
Tʼááłáhági átʼéego:Choyoołʼįįhí hr-2	Categoria:Utenti hr-2
Tʼááłáhági átʼéego:Choyoołʼįįhí hr-3	Categoria:Utenti hr-3
Tʼááłáhági átʼéego:Choyoołʼįįhí hr-4	Categoria:Utenti hr-4
Tʼááłáhági átʼéego:Choyoołʼįįhí hsb	Categoria:Utenti hsb
Tʼááłáhági átʼéego:Choyoołʼįįhí hsb-1	Categoria:Utenti hsb-1
Tʼááłáhági átʼéego:Choyoołʼįįhí hsb-2	Categoria:Utenti hsb-2
Tʼááłáhági átʼéego:Choyoołʼįįhí hsb-3	Categoria:Utenti hsb-3
Tʼááłáhági átʼéego:Choyoołʼįįhí hu	Categoria:Utenti hu
Tʼááłáhági átʼéego:Choyoołʼįįhí hu-1	Categoria:Utenti hu-1
Tʼááłáhági átʼéego:Choyoołʼįįhí hu-3	Categoria:Utenti hu-3
Tʼááłáhági átʼéego:Choyoołʼįįhí hy	Categoria:Utenti hy
Tʼááłáhági átʼéego:Choyoołʼįįhí hy-1	Categoria:Utenti hy-1
Tʼááłáhági átʼéego:Choyoołʼįįhí id-1	Categoria:Utenti id-1
Tʼááłáhági átʼéego:Choyoołʼįįhí id-2	Categoria:Utenti id-2
Tʼááłáhági átʼéego:Choyoołʼįįhí id-3	Categoria:Utenti id-3
Tʼááłáhági átʼéego:Choyoołʼįįhí io	Categoria:Utenti io
Tʼááłáhági átʼéego:Choyoołʼįįhí io-1	Categoria:Utenti io-1
Tʼááłáhági átʼéego:Choyoołʼįįhí io-2	Categoria:Utenti io-2
Tʼááłáhági átʼéego:Choyoołʼįįhí io-3	Categoria:Utenti io-3
Tʼááłáhági átʼéego:Choyoołʼįįhí is	Categoria:Utenti is
Tʼááłáhági átʼéego:Choyoołʼįįhí is-1	Categoria:Utenti is-1
Tʼááłáhági átʼéego:Choyoołʼįįhí is-2	Categoria:Utenti is-2
Tʼááłáhági átʼéego:Choyoołʼįįhí is-3	Categoria:Utenti is-3
Tʼááłáhági átʼéego:Choyoołʼįįhí is-4	Categoria:Utenti is-4
Tʼááłáhági átʼéego:Choyoołʼįįhí als-N	Categoria:Utenti als-M
Bee álnééhí:User la-3	Template:Utente la-3
Tʼááłáhági átʼéego:Choyoołʼįįhí pt-3	Categoria:Utenti pt-3
Tʼááłáhági átʼéego:Choyoołʼįįhí pl-N	Categoria:Utenti pl-M
Tʼááłáhági átʼéego:Choyoołʼįįhí pt-1	Categoria:Utenti pt-1
Tʼááłáhági átʼéego:Choyoołʼįįhí ka-1	Categoria:Utenti ka-1
Tʼááłáhági átʼéego:Choyoołʼįįhí it	Categoria:Utenti it
Tʼááłáhági átʼéego:Choyoołʼįįhí it-1	Categoria:Utenti it-1
Tʼááłáhági átʼéego:Choyoołʼįįhí ja-1	Categoria:Utenti ja-1
Tʼááłáhági átʼéego:Choyoołʼįįhí jv	Categoria:Utenti jv
Tʼááłáhági átʼéego:Choyoołʼįįhí jv-2	Categoria:Utenti jv-2
Tʼááłáhági átʼéego:Choyoołʼįįhí jv-3	Categoria:Utenti jv-3
Tʼááłáhági átʼéego:Choyoołʼįįhí ka	Categoria:Utenti ka
Tʼááłáhági átʼéego:Choyoołʼįįhí ka-2	Categoria:Utenti ka-2
Tʼááłáhági átʼéego:Choyoołʼįįhí ka-3	Categoria:Utenti ka-3
Tʼááłáhági átʼéego:Choyoołʼįįhí ka-N	Categoria:Utenti ka-M
Tʼááłáhági átʼéego:Choyoołʼįįhí km-N	Categoria:Utenti km-M
Tʼááłáhági átʼéego:Choyoołʼįįhí kn	Categoria:Utenti kn
Tʼááłáhági átʼéego:Choyoołʼįįhí kn-1	Categoria:Utenti kn-1
Tʼááłáhági átʼéego:Choyoołʼįįhí ko	Categoria:Utenti ko
Tʼááłáhági átʼéego:Wááshindoon bikéyah bił haʼdaʼhaasdzoígíí	Categoria:Stati degli Stati Uniti d'America
Tʼááłáhági átʼéego:Choyoołʼįįhí ko-1	Categoria:Utenti ko-1
Tʼááłáhági átʼéego:Choyoołʼįįhí ko-2	Categoria:Utenti ko-2
Tʼááłáhági átʼéego:Choyoołʼįįhí ko-3	Categoria:Utenti ko-3
Tʼááłáhági átʼéego:Choyoołʼįįhí ksh	Categoria:Utenti ksh
Tʼááłáhági átʼéego:Choyoołʼįįhí ksh-1	Categoria:Utenti ksh-1
Tʼááłáhági átʼéego:Choyoołʼįįhí ksh-2	Categoria:Utenti ksh-2
Tʼááłáhági átʼéego:Choyoołʼįįhí ksh-3	Categoria:Utenti ksh-3
Tʼááłáhági átʼéego:Choyoołʼįįhí ksh-N	Categoria:Utenti ksh-M
Tʼááłáhági átʼéego:Choyoołʼįįhí ku	Categoria:Utenti ku
Tʼááłáhági átʼéego:Choyoołʼįįhí la-1	Categoria:Utenti la-1
Tʼááłáhági átʼéego:Choyoołʼįįhí la-3	Categoria:Utenti la-3
Tʼááłáhági átʼéego:Choyoołʼįįhí la-4	Categoria:Utenti la-4
Tʼááłáhági átʼéego:Choyoołʼįįhí la-N	Categoria:Utenti la-M
Tʼááłáhági átʼéego:Choyoołʼįįhí lb	Categoria:Utenti lb
Tʼááłáhági átʼéego:Choyoołʼįįhí lb-1	Categoria:Utenti lb-1
Tʼááłáhági átʼéego:Choyoołʼįįhí lb-2	Categoria:Utenti lb-2
Tʼááłáhági átʼéego:Choyoołʼįįhí lb-3	Categoria:Utenti lb-3
Tʼááłáhági átʼéego:Dibé Nitsaa Hahoodzodi kin naaznilígíí	Categoria:Comuni del Colorado
Bee álnééhí:User sh	Template:Utente sh
Tʼááłáhági átʼéego:Choyoołʼįįhí nn-2	Categoria:Utenti nn-2
Tʼááłáhági átʼéego:Choyoołʼįįhí ru-1	Categoria:Utenti ru-1
Bee álnééhí:User ta	Template:Utente ta
Bee álnééhí:User sv-1	Template:Utente sv-1
Tʼááłáhági átʼéego:Chʼil bikétłʼóól daadánígíí	Categoria:Radici e tuberi commestibili
Tʼááłáhági átʼéego:Choyoołʼįįhí lo	Categoria:Utenti lo
Tʼááłáhági átʼéego:Choyoołʼįįhí lo-1	Categoria:Utenti lo-1
Tʼááłáhági átʼéego:Choyoołʼįįhí lv	Categoria:Utenti lv
Tʼááłáhági átʼéego:Choyoołʼįįhí ms-1	Categoria:Utenti ms-1
Nahasdzáán bimagnetic field	Campo geomagnetico
Tʼááłáhági átʼéego:Choyoołʼįįhí als-3	Categoria:Utenti als-3
Bee álnééhí:User id	Template:Utente id
Tʼááłáhági átʼéego:Choyoołʼįįhí nds	Categoria:Utenti nds
Tʼááłáhági átʼéego:Choyoołʼįįhí nds-1	Categoria:Utenti nds-1
Tʼááłáhági átʼéego:Choyoołʼįįhí nds-2	Categoria:Utenti nds-2
Tʼááłáhági átʼéego:Choyoołʼįįhí nds-3	Categoria:Utenti nds-3
Tʼááłáhági átʼéego:Choyoołʼįįhí nds-N	Categoria:Utenti nds-M
Tʼááłáhági átʼéego:Kéyah Ałhidadiidzooígíí dóó Ahiih Yikaígíí	Categoria:Organizzazioni internazionali
Tʼááłáhági átʼéego:Chʼosh bijáád dahólónígíí	Categoria:Artropodi
Tʼááłáhági átʼéego:Tó	Categoria:Acqua
Tʼááłáhági átʼéego:Tsáʼásziʼ dóó Noodah	Categoria:Agavaceae
Tʼááłáhági átʼéego:Bidił daazdoígíí dóó daʼalghałígíí	Categoria:Carnivori
Tʼááłáhági átʼéego:Choyoołʼįįhí tt-N	Categoria:Utenti tt-M
Tʼááłáhági átʼéego:Choyoołʼįįhí nn-1	Categoria:Utenti nn-1
Bee álnééhí:User sw-1	Template:Utente sw-1
Bee álnééhí:User af	Template:Utente af
Tʼááłáhági átʼéego:Naakaii Łizhiní Bikéyah	Categoria:Stati dell'Africa
Bee álnééhí:User da-3	Template:Utente da-3
Bee álnééhí:User ja-2	Template:Utente ja-2
Bee álnééhí:User ko-1	Template:Utente ko-1
Bee álnééhí:User cs	Template:Utente cs
Bee álnééhí:User ru-2	Template:Utente ru-2
Bee álnééhí:User es-3	Template:Utente es-3
Bee álnééhí:User ja-3	Template:Utente ja-3
Bee álnééhí:User ko-3	Template:Utente ko-3
Tʼááłáhági átʼéego:Choyoołʼįįhí pt-2	Categoria:Utenti pt-2
Tʼááłáhági átʼéego:Choyoołʼįįhí pt-4	Categoria:Utenti pt-4
Tʼááłáhági átʼéego:Choyoołʼįįhí pt-N	Categoria:Utenti pt-M
Tʼááłáhági átʼéego:Choyoołʼįįhí qu	Categoria:Utenti qu
Tʼááłáhági átʼéego:Choyoołʼįįhí qu-1	Categoria:Utenti qu-1
Tʼááłáhági átʼéego:Choyoołʼįįhí qu-2	Categoria:Utenti qu-2
Tʼááłáhági átʼéego:Choyoołʼįįhí qu-3	Categoria:Utenti qu-3
Tʼááłáhági átʼéego:Choyoołʼįįhí qu-N	Categoria:Utenti qu-M
Tʼááłáhági átʼéego:Choyoołʼįįhí ro-2	Categoria:Utenti ro-2
Tʼááłáhági átʼéego:Choyoołʼįįhí ro-3	Categoria:Utenti ro-3
Tʼááłáhági átʼéego:Choyoołʼįįhí ro-4	Categoria:Utenti ro-4
Tʼááłáhági átʼéego:Choyoołʼįįhí ro-N	Categoria:Utenti ro-M
Tʼááłáhági átʼéego:Choyoołʼįįhí ru	Categoria:Utenti ru
Tʼááłáhági átʼéego:Choyoołʼįįhí ru-2	Categoria:Utenti ru-2
Tʼááłáhági átʼéego:Choyoołʼįįhí ru-3	Categoria:Utenti ru-3
Tʼááłáhági átʼéego:Choyoołʼįįhí ru-4	Categoria:Utenti ru-4
Tʼááłáhági átʼéego:Choyoołʼįįhí sk-1	Categoria:Utenti sk-1
Tʼááłáhági átʼéego:Choyoołʼįįhí sk-3	Categoria:Utenti sk-3
Tʼááłáhági átʼéego:Choyoołʼįįhí sr	Categoria:Utenti sr
Tʼááłáhági átʼéego:Choyoołʼįįhí sr-1	Categoria:Utenti sr-1
Tʼááłáhági átʼéego:Choyoołʼįįhí sr-2	Categoria:Utenti sr-2
Tʼááłáhági átʼéego:Choyoołʼįįhí sr-3	Categoria:Utenti sr-3
Tʼááłáhági átʼéego:Choyoołʼįįhí sr-4	Categoria:Utenti sr-4
Tʼááłáhági átʼéego:Choyoołʼįįhí sr-N	Categoria:Utenti sr-M
Tʼááłáhági átʼéego:Choyoołʼįįhí sv-1	Categoria:Utenti sv-1
Tʼááłáhági átʼéego:Choyoołʼįįhí sv-3	Categoria:Utenti sv-3
Tʼááłáhági átʼéego:Choyoołʼįįhí sv-N	Categoria:Utenti sv-M
Tʼááłáhági átʼéego:Choyoołʼįįhí ta-1	Categoria:Utenti ta-1
Tʼááłáhági átʼéego:Choyoołʼįįhí th-1	Categoria:Utenti th-1
Tʼááłáhági átʼéego:Choyoołʼįįhí th-2	Categoria:Utenti th-2
Tʼááłáhági átʼéego:Choyoołʼįįhí th-3	Categoria:Utenti th-3
Tʼááłáhági átʼéego:Choyoołʼįįhí th-N	Categoria:Utenti th-M
Tʼááłáhági átʼéego:Choyoołʼįįhí tr	Categoria:Utenti tr
Tʼááłáhági átʼéego:Choyoołʼįįhí tr-4	Categoria:Utenti tr-4
Tʼááłáhági átʼéego:Choyoołʼįįhí tr-N	Categoria:Utenti tr-M
Tʼááłáhági átʼéego:Choyoołʼįįhí tt	Categoria:Utenti tt
Tʼááłáhági átʼéego:Choyoołʼįįhí uk-1	Categoria:Utenti uk-1
Tʼááłáhági átʼéego:Choyoołʼįįhí uk-2	Categoria:Utenti uk-2
Tʼááłáhági átʼéego:Choyoołʼįįhí uk-3	Categoria:Utenti uk-3
Tʼááłáhági átʼéego:Choyoołʼįįhí uk-4	Categoria:Utenti uk-4
Tʼááłáhági átʼéego:Choyoołʼįįhí vi	Categoria:Utenti vi
Tʼááłáhági átʼéego:Choyoołʼįįhí vi-1	Categoria:Utenti vi-1
Tʼááłáhági átʼéego:Choyoołʼįįhí vi-2	Categoria:Utenti vi-2
Tʼááłáhági átʼéego:Choyoołʼįįhí vi-N	Categoria:Utenti vi-M
Tʼááłáhági átʼéego:Choyoołʼįįhí vls	Categoria:Utenti vls
Tʼááłáhági átʼéego:Choyoołʼįįhí vls-1	Categoria:Utenti vls-1
Tʼááłáhági átʼéego:Choyoołʼįįhí yue-1	Categoria:Utenti zh-yue-1
Tʼááłáhági átʼéego:Choyoołʼįįhí yue-N	Categoria:Utenti yue-M
Bee álnééhí:User ro-1	Template:Utente ro-1
Tʼááłáhági átʼéego:Tsin ííʼáhígíí	Categoria:Alberi
Bee álnééhí:User ca	Template:Utente ca
Tʼááłáhági átʼéego:Mágí: Diné Ndahalinígíí	Categoria:Ominidi
Tʼááłáhági átʼéego:Mágí	Categoria:Primati
Bee álnééhí:User sv-3	Template:Utente sv-3
Bee álnééhí:User hy-1	Template:Utente hy-1
Bee álnééhí:User hsb-1	Template:Utente hsb-1
Bee álnééhí:User hsb	Template:Utente hsb
Tʼááłáhági átʼéego:Naʼiiniʼ	Categoria:Commercio
Bee álnééhí:User hsb-2	Template:Utente hsb-2
Bee álnééhí:User af-3	Template:Utente af-3
Tʼááłáhági átʼéego:Naaki góneʼ yéigo daʼahijoogą́ą́ʼ	Categoria:Seconda guerra mondiale
Tʼááłáhági átʼéego:Mósí dóó Náshdóí	Categoria:Felidi
Bee álnééhí:User nds	Template:Utente nds
Bee álnééhí:User az-2	Template:Utente az-2
Bee álnééhí:User be	Template:Utente be
Bee álnééhí:User ca-2	Template:Utente ca-2
Bee álnééhí:User ca-3	Template:Utente ca-3
Bee álnééhí:User cs-3	Template:Utente cs-3
Bee álnééhí:User fa-4	Template:Utente fa-4
Bee álnééhí:User ga-2	Template:Utente ga-2
Bee álnééhí:User he-3	Template:Utente he-3
Bee álnééhí:User he-4	Template:Utente he-4
Bee álnééhí:User ko	Template:Utente ko
Bee álnééhí:User la-2	Template:Utente la-2
Bee álnééhí:User mk-1	Template:Utente mk-1
Bee álnééhí:User nn-2	Template:Utente nn-2
Bee álnééhí:User no-1	Template:Utente no-1
Bee álnééhí:User pl-2	Template:Utente pl-2
Bee álnééhí:User pt	Template:Utente pt
Bee álnééhí:User ru-1	Template:Utente ru-1
Bee álnééhí:User sk-1	Template:Utente sk-1
Bee álnééhí:User sk-2	Template:Utente sk-2
Bee álnééhí:User sr-1	Template:Utente sr-1
Bee álnééhí:User uk-1	Template:Utente uk-1
Bee álnééhí:User uk-4	Template:Utente uk-4
Bee álnééhí:User zh-1	Template:Utente zh-1
Bee álnééhí:User zh-2	Template:Utente zh-2
Bee álnééhí:User zh-3	Template:Utente zh-3
Tʼááłáhági átʼéego:Naakaii Łizhiní Bikéyahdę́ę́ʼ Ndaaldeehii	Categoria:Fauna africana
Tʼááłáhági átʼéego:Choyoołʼįįhí nl	Categoria:Utenti nl
Tʼááłáhági átʼéego:Choyoołʼįįhí nn-3	Categoria:Utenti nn-3
Tʼááłáhági átʼéego:Choyoołʼįįhí no-1	Categoria:Utenti no-1
Tʼááłáhági átʼéego:Choyoołʼįįhí no-2	Categoria:Utenti no-2
Tʼááłáhági átʼéego:Choyoołʼįįhí no	Categoria:Utenti no
Tʼááłáhági átʼéego:Choyoołʼįįhí pi-1	Categoria:Utenti pi-1
Tʼááłáhági átʼéego:Choyoołʼįįhí zh-1	Categoria:Utenti zh-1
Tʼááłáhági átʼéego:Choyoołʼįįhí zh-3	Categoria:Utenti zh-3
Tʼááłáhági átʼéego:Choyoołʼįįhí zh-2	Categoria:Utenti zh-2
Tʼááłáhági átʼéego:Chʼał	Categoria:Anuri
Tʼááłáhági átʼéego:Atłʼóóh	Categoria:Tessitura
Tʼááłáhági átʼéego:Mąʼii yił Ałhidanoolinígíí Yázhí	Categoria:Procionidi
Tʼááłáhági átʼéego:Dlǫ́ʼiitsoh Danilínígíí	Categoria:Viverridi
Tʼááłáhági átʼéego:Chéłchaaʼ	Categoria:Coleotteri
Tʼááłáhági átʼéego:Naakáí dootłʼizhí dóó Bééshbichʼahii dabizaad ndahalinígíí	Categoria:Lingue indoeuropee
Tʼááłáhági átʼéego:Hazéí	Categoria:Scoiattoli
Tʼááłáhági átʼéego:Chidí naatʼaʼí ńdinibįįhígi	Categoria:Aeroporti
Tʼááłáhági átʼéego:Áʼádaatʼéhígíí	Categoria:Elementi chimici
Bee álnééhí:User als-2	Template:Utente als-2
Bee álnééhí:User de-4	Template:Utente de-4
Tʼááłáhági átʼéego:Biwooʼ Ádaałtsʼíísígíí dóó Kááʼtsʼiní	Categoria:Xenartri
Chʼoshtsoh bíláshgaantsohí (tónílį́įgiʼígíí)	Astacoidea
Tʼááłáhági átʼéego:Abeʼ bitsʼą́ą́dóó ádaalyaaígíí	Categoria:Prodotti caseari
Tʼááłáhági átʼéego:Tsin dóó chʼil bineestʼąʼ	Categoria:Frutta
Tʼááłáhági átʼéego:Kʼaalógii dóó Iichʼąhii	Categoria:Lepidotteri
Tʼááłáhági átʼéego:Chʼosh bijáád ádaadinígíí	Categoria:Molluschi
Tʼááłáhági átʼéego:Deeteel Bikéyah bił haʼdaʼhaasdzoígíí	Categoria:Province canadesi
Tʼááłáhági átʼéego:Gáagii dóó Joogii Ndahalinígíí	Categoria:Corvidae
Tʼááłáhági átʼéego:Mąʼii dóó Łééchąąʼí	Categoria:Canidi
Tʼááłáhági átʼéego:Tó Wónaanídę́ę́ʼ Mágí	Categoria:Cercopitecidi
Tʼááłáhági átʼéego:Naayízí dóó taʼneeskʼání	Categoria:Cucurbitaceae
Tʼááłáhági átʼéego:Dlǫ́ʼii Ndahalinígíí	Categoria:Mustelidi
Tʼááłáhági átʼéego:Naaldeehii	Categoria:Animali
Tʼááłáhági átʼéego:Shádiʼááhdę́ę́ʼ Ndaaldeehii	Categoria:Fauna sudamericana
Tʼááłáhági átʼéego:Bizaʼazis Dahólónígíí	Categoria:Marsupiali
Tʼááłáhági átʼéego:Chʼosh chʼééh diikáhii	Categoria:Gasteropodi
Tʼááłáhági átʼéego:Chʼosh bitsʼaʼígíí	Categoria:Bivalvi
Tʼááłáhági átʼéego:Gah	Categoria:Lagomorfi
Tʼááłáhági átʼéego:Łóóʼtsoh dóó Tééh hóyáanii	Categoria:Cetacei
Bee álnééhí:User bn	Template:Utente bn
Bee álnééhí:User bn-2	Template:Utente bn-2
Tʼááłáhági átʼéego:Eʼeʼaahjí Tónteel bikáaʼgi Kéyah dah Ndaaʼeełígíí	Categoria:Isole dell'oceano Pacifico
Tʼááłáhági átʼéego:Łóóʼ Bigaan Dahólónígíí	Categoria:Cefalopodi
Tʼááłáhági átʼéego:Chʼééh digháhii dóó Tsisteeł	Categoria:Cheloni
Dah diníilghaazh	Taco indiano
Tʼááłáhági átʼéego:Béésh	Categoria:Metalli
Tʼááłáhági átʼéego:Naayééʼ	Categoria:Dinosauri
Tʼááłáhági átʼéego:Choyoołʼįįhí pi	Categoria:Utenti pi
Tʼááłáhági átʼéego:Choyoołʼįįhí pl	Categoria:Utenti pl
Tʼááłáhági átʼéego:Chʼosh bikágí dantłʼizí	Categoria:Crostacei
Tʼááłáhági átʼéego:Jaaʼabaní	Categoria:Chirotteri
Tʼááłáhági átʼéego:Tłʼiish	Categoria:Serpenti
Tʼááłáhági átʼéego:Shádiʼááhjí kéyah yistinígíí	Categoria:Antartide
Tʼááłáhági átʼéego:Beʼekʼid	Categoria:Laghi
Kʼíshíshjį́į́zh	Toxicodendron radicans
Bee álnééhí:User sw-3	Template:Utente sw-3
Tʼááłáhági átʼéego:Łóóʼ hashkéhé	Categoria:Selachimorpha
Tʼááłáhági átʼéego:Łóóʼ ooshgę́ęzhii	Categoria:Chondrichthyes
Bee álnééhí:User hsb-3	Template:Utente hsb-3
Tʼááłáhági átʼéego:Chidí	Categoria:Automobili
Bee álnééhí:User ga-1	Template:Utente ga-1
Bee álnééhí:User lb	Template:Utente lb
Bee álnééhí:User af-2	Template:Utente af-2
Chąąshtʼezhiitsoh	Daucus carota
Tséyooʼáałii	Curculionidae
Tʼááłáhági átʼéego:Wóʼatsʼǫǫsii Ádaatʼéhígíí	Categoria:Rincoti
Tʼááłáhági átʼéego:Tsin Deigházhígíí	Categoria:Roditori
Bee álnééhí:User sl-1	Template:Utente sl-1
Bee álnééhí:User pl-3	Template:Utente pl-3
Bee álnééhí:User an-1	Template:Utente an-1
Bee álnééhí:User sw	Template:Utente sw
Bee álnééhí:User sr-3	Template:Utente sr-3
Bee álnééhí:User sh-1	Template:Utente sh-1
Bee álnééhí:User sc-1	Template:Utente sc-1
Bee álnééhí:User pi-1	Template:Utente pi-1
Bee álnééhí:User mk	Template:Utente mk
Bee álnééhí:User lt-1	Template:Utente lt-1
Bee álnééhí:User lo-1	Template:Utente lo-1
Bee álnééhí:User la	Template:Utente la
Bee álnééhí:User ksh-3	Template:Utente ksh-3
Bee álnééhí:User ksh-2	Template:Utente ksh-2
Bee álnééhí:User ksh-1	Template:Utente ksh-1
Bee álnééhí:User it-4	Template:Utente it-4
Bee álnééhí:User grc-3	Template:Utente grc-3
Bee álnééhí:User ga	Template:Utente ga
Bee álnééhí:User bs-2	Template:Utente bs-2
Bee álnééhí:User bg-3	Template:Utente bg-3
Bee álnééhí:User bg-2	Template:Utente bg-2
Bee álnééhí:User be-3	Template:Utente be-3
Bee álnééhí:User be-1	Template:Utente be-1
Bee álnééhí:User an	Template:Utente an
Bee álnééhí:User ast	Template:Utente ast
Bee álnééhí:User mzn-2	Template:Utente mzn-2
Tʼááłáhági átʼéego:Dlǫ́ʼii yił Aheedaałtʼéhígíí	Categoria:Erpestidi
Bee álnééhí:User or	Template:Utente or
Tʼááłáhági átʼéego:Choyoołʼįįhí lzh-2	Categoria:Utenti lzh-2
Bee álnééhí:User lzh-2	Template:Utente lzh-2
Tʼááłáhági átʼéego:Hoozdo Hahoodzodi chidí naatʼaʼí ńdinibįįhígi	Categoria:Aeroporti dell'Arizona
Tʼááłáhági átʼéego:Beeʼeldííldahsinil	Categoria:Albuquerque
Tʼááłáhági átʼéego:Táłkáaʼgi Tsídii	Categoria:Anseriformes
Tʼááłáhági átʼéego:Tsísʼná dóó Wáláchííʼ	Categoria:Apocrita
Tʼááłáhági átʼéego:Chʼosh bijáád tseebíhígíí	Categoria:Aracnidi
Tʼááłáhági átʼéego:Yágháhonikáánji biłnaaztʼiʼígíí	Categoria:Esplorazione spaziale
Tʼááłáhági átʼéego:Shash	Categoria:Ursidi
Tʼááłáhági átʼéego:Tsin deiłkaałii	Categoria:Picidae
Tʼááłáhági átʼéego:Tsékooh	Categoria:Canyon
Tó bichʼoshtsoh	Belostomatidae
Tʼááłáhági átʼéego:Dziil / Atsiniltłʼish álʼį́	Categoria:Energia
Tʼááłáhági átʼéego:Shádiʼááh biyaadi dóó Kéyah Yistinígíí bikáaʼgi Ndaaldeehii	Categoria:Fauna antartica
Tʼááłáhági átʼéego:Tsʼíʼii dóó Tséʼédǫ́ʼii	Categoria:Ditteri
Tʼááłáhági átʼéego:Tązhii dóó Naaʼahóóhai Ndahalinígíí	Categoria:Galliformes
Tʼááłáhági átʼéego:Tééh łééchąąʼí	Categoria:Ienidi
Tʼááłáhági átʼéego:Kǫʼ naʼałbąąsii ninádaaltłiʼígi	Categoria:Stazioni ferroviarie
Tʼááłáhági átʼéego:Daʼałtʼoʼígíí biyęęzhii deiłchíhígíí	Categoria:Monotremi
Tʼááłáhági átʼéego:Nahachagii dóó Nahakʼízii	Categoria:Ortotteri
Tʼááłáhági átʼéego:Chéłchaaʼ bigaantéłígíí	Categoria:Scarabaeidae
Tʼááłáhági átʼéego:Tábąąsdísí	Categoria:Scolopacidae
Tʼááłáhági átʼéego:Séigoʼ	Categoria:Scorpiones
Tʼááłáhági átʼéego:Táłtłʼááhdę́ę́ʼ dóó tónteel biyiʼdę́ę́ʼ chʼiyáán	Categoria:Pesci da allevamento
Tʼááłáhági átʼéego:Tsin naaʼeeł	Categoria:Navi
Tʼááłáhági átʼéego:Naʼashjéʼii	Categoria:Araneae
Tʼááłáhági átʼéego:Jááłánii	Categoria:Miriapodi
Tʼááłáhági átʼéego:Bisóodi	Categoria:Suidi
Tʼááłáhági átʼéego:Choyoołʼįįhí ba-N	Categoria:Utenti ba-M
Tʼááłáhági átʼéego:Choyoołʼįįhí dsb-3	Categoria:Utenti dsb-3
Tʼááłáhági átʼéego:Choyoołʼįįhí no-4	Categoria:Utenti no-4
Tʼááłáhági átʼéego:Azeeʼ	Categoria:Piante medicinali e officinali
Tʼááłáhági átʼéego:Choyoołʼįįhí nl-4	Categoria:Utenti nl-4
Bee álnééhí:User cs-2	Template:Utente cs-2
Bee álnééhí:Image label begin	Template:Etichetta immagine inizio
Tʼááłáhági átʼéego:Yootó Hahoodzodi kin naaznilígíí	Categoria:Comuni del Nuovo Messico
Tʼááłáhági átʼéego:Choyoołʼįįhí lzh	Categoria:Utenti lzh
Tʼááłáhági átʼéego:Choyoołʼįįhí hsb-N	Categoria:Utenti hsb-M
Tʼááłáhági átʼéego:Dahsání dah Yikahjí Tsin Deigházhígíí	Categoria:Istricomorfi
Tʼááłáhági átʼéego:Ńdaʼatʼaałii bideeʼ dahólónígíí	Categoria:Pecora
Tʼááłáhági átʼéego:Choyoołʼįįhí fa-4	Categoria:Utenti fa-4
Bee álnééhí:User nn-3	Template:Utente nn-3
Bee álnééhí:User vi	Template:Utente vi
Tʼááłáhági átʼéego:Choyoołʼįįhí en-1	Categoria:Utenti en-1
Tʼááłáhági átʼéego:Choyoołʼįįhí de-1	Categoria:Utenti de-1
Tʼááłáhági átʼéego:Choyoołʼįįhí da-N	Categoria:Utenti da-M
Tʼááłáhági átʼéego:Choyoołʼįįhí gl-2	Categoria:Utenti gl-2
Tʼááłáhági átʼéego:Choyoołʼįįhí or	Categoria:Utenti or
Yaaʼ bijáád tseebíhígíí	Ixodida
Bee álnééhí:User ay-4	Template:Utente ay-4
Dahsání	Erethizon dorsatum
Tsiiyázhí (dééł)	Psophia
Bee álnééhí:User ru-3	Template:Utente ru-3
Bee álnééhí:User az-1	Template:Utente az-1
Bee álnééhí:User nl-3	Template:Utente nl-3
Bee álnééhí:User dsb-1	Template:Utente dsb-1
Bee álnééhí:User bar	Template:Utente bar
Bee álnééhí:User li	Template:Utente li
Bee álnééhí:User als-3	Template:Utente als-3
Bee álnééhí:User ba	Template:Utente ba
Bee álnééhí:User hu-4	Template:Utente hu-4
Bee álnééhí:User ga-3	Template:Utente ga-3
Bee álnééhí:User kn-1	Template:Utente kn-1
Bee álnééhí:Bidił daazdoígíí dóó da'ałt'o'ígíí	Template:Mammiferi
Kʼaalógii	Farfalla
Akétłʼóól łichxííʼí yázhí	Raphanus sativus
Special:RecentChanges	Speciale:UltimeModifiche
Tʼááłáhági átʼéego:Choyoołʼįįhí ja-4	Categoria:Utenti ja-4
Gaantsʼosí dóó Sǫʼ łóóʼ biyaʼ	Myzostomida
Ábishjaaʼ łóóʼ	Dendrogramma (genere)
