Africa	Africa
Lithuania	Lituania
Italia	Italia
Asia	Asia
Meyi	Maggio
Russia	Russia
Azerbaijan	Azerbaigian
San Marino (dziko)	San Marino
South Africa	Sudafrica
Algeria	Algeria
Yesu Kristu	Gesù
Chilatini	Lingua latina
Napoleon	Napoleone Bonaparte
Zomera	Plantæ
Tanzania	Tanzania
Zambia	Zambia
Zimbabwe	Zimbabwe
Malaŵi	Malawi
Mozambique	Mozambico
Sudan	Sudan
Uetersen	Uetersen
Augustus	Augusto
Baibulo	Bibbia
True Jesus Church	Vera Chiesa di Gesù
Chingerezi	Lingua inglese
Dong Hoi	Dong Hoi
Category:Templates	Categoria:Template
Lilongwe	Lilongwe
Lusaka	Lusaka
Wikipedia:Sandbox	Wikipedia:Pagina delle prove
Zichyújfalu	Zichyújfalu
Mwezi	Mese
Tsamba Lalikulu	Pagina principale
Lake Malawi	Lago Malawi
Category:Candidates for speedy deletion	Categoria:Cancellare subito
Chitsamunda	Colonialismo
Boma	Governo
Category:Kuimba	Categoria:Musica
Alexander Macedon	Alessandro Magno
Chigiriki	Lingua greca
Chiarabu	Lingua araba
Template:Link FA	Template:Link V
Wikipedia:Community Portal	Wikipedia:Bar
Bien Hoa	Biên Hòa
Chinenero ya ndzika	Lingua ufficiale
Moshchena	Moščena
ISO 3166-1	ISO 3166-1
Akhristadelfia	Cristadelfiani
Chilankhulo cha Chichewa	Lingua chewa
Wolembedwa ndi Yohane	Vangelo secondo Giovanni
Template:Commons Categories	Template:Commonscat
Aroma	Lettera ai Romani
Matenda a Ebola	Malattia da virus Ebola
Category:Boma	Categoria:Governo
Joyce Banda	Joyce Banda
Kwacha ya Zambia	Kwacha zambiano
Nsadsi	Jatropha curcas
KwaZulu-Natal	KwaZulu-Natal
Chinangwa	Manihot esculenta
Western Cape	Provincia del Capo Occidentale
Eastern Cape	Provincia del Capo Orientale
Mpumalanga	Mpumalanga
Northern Cape	Provincia del Capo Settentrionale
Gauteng	Gauteng
Limpopo	Provincia del Limpopo
Wikipedia:Chithandizo cha Kulemba pa Wikipedia	Aiuto:Modifica
Free State	Free State
Ndya	Melia azedarach
North West (South Africa)	Provincia del Nordovest (Sudafrica)
Nimu	Azadirachta indica
Akafula	Pigmei
Ezekieli	Libro di Ezechiele
Bingu wa Mutharika	Bingu wa Mutharika
Hastings Kamuzu Banda	Hastings Banda
Blantyre	Blantyre (Malawi)
Banovci (Nijemci)	Banovci
Trpinja	Trpinja
Kwacha ya Malaŵi	Kwacha malawiano
Zomba	Zomba
Zomba, Malaŵi	Zomba (Malawi)
Anggun	Anggun
Cham'mwanba	Moringa oleifera
Tsekela	Hyparrhenia
Bakili Muluzi	Elson Bakili Muluzi
Katekisma wa Heidelberg	Catechismo di Heidelberg
Senjele	Pennisetum purpureum
Limbe	Limbé
Stand and Sing of Zambia, Proud and Free	Stand and Sing of Zambia, Proud and Free
Mzuzu	Mzuzu
Baskin-Robbins	Baskin-Robbins
Nandalo	Cajanus cajan
John Chilembwe	John Chilembwe
Mfula	Sclerocarya birrea
United Democratic Front	Fronte Democratico Unito
Pigazzano	Pigazzano
Chipata	Chipata (Zambia)
Balaka	Distretto di Balaka
Katunga	Cynodon (botanica)
Malawi Congress Party	Partito del Congresso del Malawi
Kwacha	Kwacha
Democratic Progressive Party	Partito Progressista Democratico
Neno	Distretto di Neno
Category:Russia	Categoria:Russia
Category:South Africa	Categoria:Sudafrica
Category:Zomera	Categoria:Piante
Dasymys incomtus	Dasymys incomtus
Mangochi	Mangochi
Category:Akhristu	Categoria:Cristianesimo
Likoma	Likoma (città)
Mtsinje wa Shire	Shire (fiume)
Category:Stubs	Categoria:Stub
Wikipedia:Administrators	Wikipedia:Amministratori
Wikipedia:Vital 100	Wikipedia:Voci fondamentali/Lista1
Template:Bot	Template:Bot
Template:Documentation	Template:Man
Category:Wikipedians by language	Categoria:Utenti per lingua
Sung Jae-gi	Sung Jae-gi
Template:Softredirect	Template:Soft redirect
Template:Delete	Template:Cancella subito
Category:Chilankhulo	Categoria:Lingue
Category:Wikipedia	Categoria:Wikipedia
Template:-	Template:-
Template:Col-break	Template:Colonne spezza
Template:Col-end	Template:Colonne fine
Wikipedia:Vital articles	Wikipedia:Lista delle voci che tutte le Wikipedie dovrebbero avere
Category:Africa	Categoria:Africa
Category:Baibulo	Categoria:Bibbia
Category:Miyezi	Categoria:Mesi dell'anno
Template:Babel	Template:Babel
Template:Commons	Template:Commons
Template:Stub	Template:S
Template:See also	Template:Vedi anche
Template:User da	Template:Utente da
Template:User be-2	Template:Utente be-2
Template:User da-1	Template:Utente da-1
Template:User cs-1	Template:Utente cs-1
Template:User bg-1	Template:Utente bg-1
Template:User eo-3	Template:Utente eo-3
Template:User de	Template:Utente de
Template:User de-1	Template:Utente de-1
Template:User de-3	Template:Utente de-3
Template:User en-3	Template:Utente en-3
Template:User en-1	Template:Utente en-1
Template:User en-2	Template:Utente en-2
Template:User en-0	Template:Utente en-0
Template:User en	Template:Utente en
Template:User es-1	Template:Utente es-1
Template:User fr-1	Template:Utente fr-1
Template:User it-3	Template:Utente it-3
Template:User sk	Template:Utente sk
Template:User tr	Template:Utente tr
Template:User ja-1	Template:Utente ja-1
Template:User it-1	Template:Utente it-1
Template:User hr-1	Template:Utente hr-1
Category:MaBoma a South Africa	Categoria:Province del Sudafrica
Category:User uk	Categoria:Utenti uk
Category:User uk-N	Categoria:Utenti uk-M
Template:Mod	Template:Mod
Template:User uk	Template:Utente uk
Template:User es-2	Template:Utente es-2
Template:Welcome	Template:Benvenuto
Category:User fr-1	Categoria:Utenti fr-1
Template:Location map	Template:Mappa di localizzazione
Category:User en	Categoria:Utenti en
Category:User en-2	Categoria:Utenti en-2
Template:Infobox	Template:Infobox
Template:User ru-4	Template:Utente ru-4
Template:User nl-2	Template:Utente nl-2
Template:User ru	Template:Utente ru
Template:User pl-1	Template:Utente pt-1
Template:User no-2	Template:Utente no-2
Template:Purge	Template:Purga
Template:Infobox Continent	Template:Regione geografica
Template:Coord	Template:Coord
Category:User be	Categoria:Utenti be
Category:User hr	Categoria:Utenti hr
Category:User sk	Categoria:Utenti sk
Category:User sl	Categoria:Utenti sl
Category:User eo	Categoria:Utenti eo
Category:User fr	Categoria:Utenti fr
Category:User ja	Categoria:Utenti ja
Category:User mk	Categoria:Utenti mk
Category:User pt	Categoria:Utenti pt
Category:User sv	Categoria:Utenti sv
Category:User sw	Categoria:Utenti sw
Category:User it-3	Categoria:Utenti it-3
Category:User cs-1	Categoria:Utenti cs-1
Category:User da-1	Categoria:Utenti da-1
Category:User sl-1	Categoria:Utenti sl-1
Category:User mk-1	Categoria:Utenti mk-1
Category:User sw-1	Categoria:Utenti sw-1
Category:User be-2	Categoria:Utenti be-2
Category:User nl-2	Categoria:Utenti nl-2
Category:User ru-N	Categoria:Utenti ru-M
Category:User bg	Categoria:Utenti bg
Category:User bg-1	Categoria:Utenti bg-1
Category:User cs	Categoria:Utenti cs
Category:User da	Categoria:Utenti da
Category:User sk-N	Categoria:Utenti sk-M
Category:User de	Categoria:Utenti de
Category:User en-0	Categoria:Utenti en-0
Category:User en-3	Categoria:Utenti en-3
Category:User en-N	Categoria:Utenti en-M
Category:User eo-3	Categoria:Utenti eo-3
Category:User es	Categoria:Utenti es
Category:User es-1	Categoria:Utenti es-1
Category:User es-2	Categoria:Utenti es-2
Category:User hr-1	Categoria:Utenti hr-1
Category:User it	Categoria:Utenti it
Category:User it-1	Categoria:Utenti it-1
Category:User ja-1	Categoria:Utenti ja-1
Template:User sv-1	Template:Utente sv-1
Template:User sw-1	Template:Utente sw-1
Category:Maiko a ku Africa	Categoria:Stati dell'Africa
Category:User pt-N	Categoria:Utenti pt-M
Category:User ru	Categoria:Utenti ru
Category:User ru-4	Categoria:Utenti ru-4
Category:User sv-1	Categoria:Utenti sv-1
Category:User tr	Categoria:Utenti tr
Category:User tr-N	Categoria:Utenti tr-M
Category:User uk-4	Categoria:Utenti uk-4
Category:Malaŵi	Categoria:Malawi
Category:Mozambique	Categoria:Mozambico
Template:User mk-1	Template:Utente mk-1
Template:User no-1	Template:Utente no-1
Template:User pt	Template:Utente pt
Template:User uk-4	Template:Utente uk-4
Category:Zambia	Categoria:Zambia
Category:User nl	Categoria:Utenti nl
Category:User no-1	Categoria:Utenti no-1
Category:User no-2	Categoria:Utenti no-2
Category:User no	Categoria:Utenti no
Category:ZiPani za ndale	Categoria:Partiti politici
Category:Lilongwe	Categoria:Lilongwe
Template:User sl-1	Template:Utente sl-1
Trojany	Trojany
Category:ZiPani za ndale za ku Malaŵi	Categoria:Partiti politici malawiani
Category:User en-1	Categoria:Utenti en-1
Category:User de-1	Categoria:Utenti de-1
Category:User da-N	Categoria:Utenti da-M
Special:RecentChanges	Speciale:UltimeModifiche
Module:Coordinates	Modulo:Coord
