افريقا	Africa
جاپان	Giappone
سوېلي امريکا	America Meridionale
ناروې	Norvegia
د آيرلېنډ جمهوريت	Irlanda
هنگري	Ungheria
اسپانیا	Spagna
د امریکا متحده ایالتونه	Stati Uniti d'America
بلجیم	Belgio
لوگزامبورگ	Lussemburgo
ځمکه	Terra
ژوند	Vita
انسان	Homo sapiens
فېنلانډ	Finlandia
سويډن	Svezia
ډېنمارک	Danimarca
پولنډ	Polonia
لېتوانيا	Lituania
اېټاليا	Italia
سويس	Svizzera
اتريش	Austria
يونان	Grecia
تورکيه	Turchia
بير	Birra
پرتگال	Portogallo
اروپا	Europa
آسيا	Asia
شمالي امريکا	America del Nord
انټارکټيکا	Antartide
ويکيپېډيا	Wikipedia
هالنډ	Paesi Bassi
نيويارک (ښار)	New York
واشنگټن ډي سي	Washington
برلين	Berlino
سولگر	Computer
څوریخ	Zurigo
انټرنټ	Internet
باراک حسين اوباما	Barack Obama
لندن	Londra
قاهره	Il Cairo
مڼه	Mela
پاريس	Parigi
گووگل	Google Inc.
اتلانتيک سمندر	Oceano Atlantico
غلی سمندر	Oceano Pacifico
کالېفورنیا	California
دونۍ	Lunedì
جنوري	Gennaio
فبروري	Febbraio
مارچ	Marzo
مريخ	Marte (astronomia)
کېنيا	Kenya
اېتوپیا	Etiopia
گانا	Ghana
اپرېل	Aprile
مې	Maggio
جون	Giugno
جولای	Luglio
اگسټ	Agosto
سپټمبر	Settembre
اکتوبر	Ottobre
نومبر	Novembre
ډيسمبر	Dicembre
درې نۍ	Martedì
شورو	Mercoledì
زيارت	Giovedì
جمعه	Venerdì
خالي	Sabato
يونۍ	Domenica
زمری	Panthera leo
فرانسه	Francia
سپی	Canis lupus familiaris
بريتانيا	Regno Unito
پيشو	Felis silvestris catus
چين د خلکو جمهوريت	Cina
فرانسوي ژبه	Lingua francese
اېتنول	Etanolo
برازیل	Brasile
روسیه	Russia
نهنگ	Cetacea
څلوريځ (مېچپوهنه)	Quadrato
بوینگ ۷۴۷	Boeing 747
ويکيمېډيا بنسټ	Wikimedia Foundation
آلمان	Germania
بېلاروس	Bielorussia
آلماني ژبه	Lingua tedesca
آيسلېنډ	Islanda
الله	Dio
اېسټونيا	Estonia
زحل	Saturno (astronomia)
الوتکه	Aeroplano
جگړه	Guerra
جورج واکر بوش	George W. Bush
اوکراین	Ucraina
چېک جمهوريت	Repubblica Ceca
سلواکيا	Slovacchia
سلووانیا	Slovenia
مولدوا	Moldavia
رومانیا	Romania
بلغاریا	Bulgaria
د مقدونيې ولسمشريزه	Repubblica di Macedonia
البانیا	Albania
کروواسيا	Croazia
آزربايجان	Azerbaigian
اندورا	Andorra
گرجستان	Georgia
قزاقستان	Kazakistan
مالټا	Malta
مانتېنېگرو	Montenegro
واټيکان ښار	Città del Vaticano
سان مارینو	San Marino
بروکسل	Regione di Bruxelles-Capitale
بېلیز	Belize
باربادوس	Barbados
اندونيزيا	Indonesia
ولفگانگ امادیوس موزارت	Wolfgang Amadeus Mozart
لیودویگ وان بیتهووین	Ludwig van Beethoven
تورکي ژبه	Lingua turca
سویلي افریقا	Sudafrica
الجزاير	Algeria
اوزبکستان	Uzbekistan
تاشکند	Tashkent
اوبه	Acqua
تلويزون	Televisione
چېلي	Cile
عيسی	Gesù
گاليليو گاليلی	Galileo Galilei
عطارد	Mercurio (astronomia)
پېښليک	Storia
ژبه	Linguaggio
زورواکي	Dittatura
مشتري	Giove (astronomia)
میشل باشله	Michelle Bachelet
ستورپوهنه	Astronomia
سينگاپور	Singapore
پوهنه	Scienza
تکړښت	Sport
اډولف هټلر	Adolf Hitler
فېس بوک	Facebook
ويکيلېکس	WikiLeaks
لومړنۍ نړېواله جگړه	Prima guerra mondiale
دويمه نړېواله جگړه	Seconda guerra mondiale
گړيال	Orologio
شچېچېن	Stettino
شمېرپوهنه	Matematica
لاتين ژبه	Lingua latina
بحرین	Bahrein
ارمنستان	Armenia
مېخي ليکدود	Scrittura cuneiforme
هیگزبوسون	Bosone di Higgs
سربيا	Serbia
سپوږمۍ	Luna
استنبول	Istanbul
آسټراليا	Australia
پنځپوهنه	Fisica
ارجنټاین	Argentina
مخابرات	Telecomunicazione
پيرو	Perù
ژونپوهنه	Biologia
شمالي کوريا	Corea del Nord
کمبودیا	Cambogia
قرآن	Corano
ډانگسر	Dinosauria
ژوپوهنه	Zoologia
اسلام	Islam
ناک	Pyrus
بوټپوهنه	Botanica
لېخ والېسا	Lech Wałęsa
اروپايي اتحاديه	Unione europea
WWW	World Wide Web
شعر	Poesia
کمپيوټري ويروس	Virus (informatica)
ليمو	Citrus × limon
گل	Fiore
ناپليون بوناپارت	Napoleone Bonaparte
لمر	Sole
آسمان	Cielo
وېکټور هوگو	Victor Hugo
اقيانوسيه	Oceania
لمريز غونډال	Sistema solare
هايډروجن	Idrogeno
انگېلا مېرکل	Angela Merkel
لوړغږی	Altoparlante
ورځ	Giorno
شپه	Notte
کال	Anno
پېړۍ	Secolo
اوسلو	Oslo
دوبۍ	Dubai
آکسيجن	Ossigeno
سياره	Pianeta
سندارا	Musica
مسکو	Mosca (Russia)
چاډ	Ciad
الومېنيم	Alluminio
هند	India
اوسپنه	Ferro
لوېديځ	Ovest
گوگړ	Zolfo
ساموا	Samoa
ختيځ	Est
وېليم شېکسپيير	William Shakespeare
نكل	Favola
مارشال ټاپووان	Isole Marshall
مغولستان	Mongolia
سترنج	Scacchi
چنگېز خان	Gengis Khan
آس	Equus caballus
امسټرډام	Amsterdam
وسله	Arma
ژوي	Animalia
سورينام	Suriname
گويانا	Guyana
اېکوادور	Ecuador
ځمکني توتان	Fragaria
بوديزم	Buddhismo
بولېویا	Bolivia
تامبه	Rame
بوټی	Plantæ
سېنټ لوسیا	Santa Lucia (Stato)
ليونارډو ډاوېنچي	Leonardo da Vinci
چڼاس	Fungi
جمايکا	Giamaica
گرېنادا	Grenada
گواتمالا	Guatemala
هندوراس	Honduras
ډومنيکان جمهوريت	Repubblica Dominicana
اهلي خوگ	Sus scrofa domesticus
شمالي قطبي سمندر	Mar Glaciale Artico
هایتي	Haiti
اېلسلوادور	El Salvador
ايران	Iran
عراق	Iraq
کوسټاریکا	Costa Rica
اسرائيل	Israele
پاناما	Panamá
يمن	Yemen
اردن	Giordania
نیکاراگوا	Nicaragua
قرغزستان	Kirghizistan
کوېټ	Kuwait
لاووس	Laos
لېبنان	Libano
مالديپ	Maldive
امريکا لويه وچه	America
ميانمار	Birmania
نيپال	Nepal
عمان	Oman
پاکستان	Pakistan
قطر	Qatar
سعودي عربستان	Arabia Saudita
سریلانکا	Sri Lanka
جوزف سټالين	Iosif Stalin
سوريه	Siria
اپلاتون	Platone
تاجيکستان	Tagikistan
د چين جمهوريت	Taiwan
يوټيوب	YouTube
ارستو	Aristotele
تايلنډ	Thailandia
اورگاډی	Treno
آرسېنيک	Arsenico
راډيو	Radio (elettronica)
تورکمنستان	Turkmenistan
عربي متحده امارات	Emirati Arabi Uniti
چارلس چاپلين	Charlie Chaplin
سوېلي کوريا	Corea del Sud
سمپسنز	I Simpson
افغانستان	Afghanistan
بنگله دېش	Bangladesh
فرانتس کافکا	Franz Kafka
مالي	Mali
سوقرات	Socrate
آنگولا	Angola
بوتان	Bhutan
ټويټر	Twitter
برونای	Brunei
تانزانیه	Tanzania
پاره	Mercurio (elemento chimico)
فلېپين	Filippine
د منځنی افريقا ولسمشريزه	Repubblica Centrafricana
آيزاک نيوټن	Isaac Newton
آلبرټ آينشټاين	Albert Einstein
تونس	Tunisia
زېمبيا	Zambia
زېمبابوې	Zimbabwe
بېجنگ	Pechino
سوېلي سوډان	Sudan del Sud
بېنين	Benin
بوتسوانا	Botswana
بورکینا فاسو	Burkina Faso
بروندي	Burundi
کانگو جمهوريت	Repubblica del Congo
جېبوتي	Gibuti
پولونيم	Polonio
باډن ورټمبرگ	Baden-Württemberg
اریتره	Eritrea
فيودور ميخايلوويچ داستاېفسکي	Fëdor Dostoevskij
گابن	Gabon
مهاتما گاندي	Mahatma Gandhi
گامبيا	Gambia
عاج ساحل	Costa d'Avorio
کامرون	Camerun
لايبېريا	Liberia
لېبيا	Libia
مادغاسکر	Madagascar
مالاوي	Malawi
موریتانيا	Mauritania
ماوریتوس	Mauritius
مراکش	Marocco
موزمبيق	Mozambico
نېمبیا	Namibia
نایجېر	Niger
نايجېريا	Nigeria
راونډا	Ruanda
سېنېگال	Senegal
سیشل	Seychelles
سېرالیون	Sierra Leone
سومالیا	Somalia
سوډان	Sudan
سوازيلانډ	Swaziland
شنه زرغونه	Arcobaleno
استقلاب	Metabolismo
ملگري ملتونه	Organizzazione delle Nazioni Unite
دانتې الیگيري	Dante Alighieri
ځمکپېژندنه	Geologia
ځمکپوهنه	Geografia
زړه	Cuore umano
ماغزه	Cervello
پراگ	Praga
شين	Blu
سپين زر	Argento
يورانيم	Uranio
پلوتونيم	Plutonio
ممبای	Mumbai
گوا	Goa
مهاراشترا	Maharashtra
زارلاند	Saarland
براندنبورگ	Brandeburgo
برېمن (ايالت)	Brema (stato)
بيت المقدس	Gerusalemme
هندي سمندر	Oceano Indiano
کلراډو	Colorado
ژمی	Inverno
پسرلی	Primavera
دوبی	Estate
منی	Autunno
اسامه بن لادن	Osama bin Laden
اوپرا	Opera
کلکته	Calcutta
ډېلي	Delhi
بند پایان	Arthropoda
اسلام آباد	Islamabad
پيسې	Denaro
خوځندکې	Insecta
ولادمير ايليچ لېنين	Lenin
نېكولو مكياوېلې	Niccolò Machiavelli
مايکروسافټ وېنډوز	Microsoft Windows
مانيلا	Manila
توکيو	Tokyo
استانه	Astana
بغداد	Baghdad
هندي ژبه	Lingua hindi
اوردو ژبه	Lingua urdu
واليبال	Pallavolo
وين	Vienna
ډبلن	Dublino
بوډاپسټ	Budapest
د مسيح حقيقي کليسا	Vera Chiesa di Gesù
انگرېزي ژبه	Lingua inglese
بانگکوک	Bangkok
کوالالامپور	Kuala Lumpur
ديپلوماسي	Diplomazia
کيېف	Kiev
كونسكوولا	Końskowola
2012	2012
2013	2013
خواړه	Alimento
اېلېکټرون	Elettrone
رغاويز اوښتون	Rivoluzione industriale
د روم ټولواکمني	Impero romano
مايکروسافټ	Microsoft
پروټون	Protone
کوروف	Kurów
کيميا	Chimica
نيوټرون	Neutrone
صنعا	Sana’a
آرنولد شوارزنېگر	Arnold Schwarzenegger
فوټبال	Calcio (sport)
آيفون	IPhone
مايکل جېکسن	Michael Jackson
انتوان دي سينت اکسيوپيري	Antoine de Saint-Exupéry
سور	Rosso
هوا	Atmosfera terrestre
پېرى	Jinn
ربات	Rabat
الجزيره	Algeri
ترابلس	Tripoli
تهران	Teheran
جکارتا	Giacarta
انقره	Ankara
رياض	Riyad
فوټ	Piede (unità di misura)
وېشنيزه:د ويکيپېډيا کينډۍ	Categoria:Template
د مشق	Damasco
لوم	Lomé
دوها	Doha
دودوما	Dodoma
ښوونځی	Scuola
پوهنتون	Università
د پوهنغونډ په اړه	Aiuto:Benvenuto
آسټراليا (لويه وچه)	Australia (continente)
ورونپاسی	Computer portatile
الجبر	Algebra
دونگ هوی هوايي ډگر	Aeroporto di Dong Hoi
آر دړه	Scheda madre
كوريتيبا	Curitiba
پنجاب (پاکستان)	Punjab (Pakistan)
وېشنيزه:د افغانستان پېښليک	Categoria:Storia dell'Afghanistan
توماس شېن کانېري	Sean Connery
كنفيوشيوس	Confucio
کوربن بليو	Corbin Bleu
وېشنيزه:شمېرپوهنه	Categoria:Matematica
وېشنيزه:د ایران تاریخ	Categoria:Storia dell'Iran
امريکايي ډالر	Dollaro statunitense
عيسويت	Cristianesimo
لويه وچه	Continente
مرغه	Aves
پلازمېنه	Capitale (città)
مياشت (موده)	Mese
مصطفی کمال اتاتورک	Mustafa Kemal Atatürk
کينډۍ:تانبه	Template:Portale
هوانگ شيان فان	Huang Xianfan
بقراط	Ippocrate
الماس	Diamante
پوهنغونډ	Enciclopedia
RAM	RAM
لومړی مخ	Pagina principale
کانډنسر	Condensatore (elettrotecnica)
باسکټبال	Pallacanestro
کرېکټ	Cricket
اوراسيا	Eurasia
د هېتیانو واکمنۍ	Ittiti
وينه لږی	Anemia
کېپ ټاون	Città del Capo
قراقرم	Karakorum
هندوکش	Hindu Kush
ميترو	Metropolitana
کنځری	Cotoneaster
پيکاسو	Pablo Picasso
بس	Autobus
ټرام	Tram
بابل	Babilonia
آنتون پاولوف چيخوف	Anton Čechov
چارلېز ډيکېنز	Charles Dickens
سپارتا	Sparta
موينجو دېړو	Mohenjo-daro
سمرقند	Samarcanda
بخارا	Bukhara
چې گوارا	Che Guevara
کابل	Kabul
گوېټه	Johann Wolfgang von Goethe
مهبل	Vagina
فلسفه	Filosofia
د مقدس ویټوس کليسا	Cattedrale di San Vito
چای	Tè
کمونيزم	Comunismo
انارشيزم	Anarchismo
پانگولي	Capitalismo
لېبراليزم	Liberalismo
فاشېزم	Fascismo
ولسپالنه	Nazionalismo
حافظ شېرازي	Hafez
هېوادپالنه	Patriottismo
هیواد	Paese (area geografica)
ولس	Nazione
هيلري کلنټن	Hillary Clinton
د برتانيې موزيم	British Museum
ژان ژاک روسو	Jean-Jacques Rousseau
هومر	Omero
الكساندر هومبولدت	Alexander von Humboldt
کوارک	Quark (particella)
اېډوارډ ټېللر	Edward Teller
تور زېړی	Epatite B
اتيزم	Ateismo
نيلز بوهر	Niels Bohr
ژونکيميا	Biochimica
ژونپنځپوهنه	Biofisica
چاپېريالپوهنه	Ecologia
بارسلونا فوټبال کلب	Futbol Club Barcelona
واگ	Politica
ووبپوهنه	Istologia
عربي ټولنه	Lega araba
ولسواکي	Democrazia
نجيب محفوظ	Naguib Mahfouz
د سره صليب او سرې مياشتې نړيوال غورځنگ	Croce Rossa e Mezzaluna Rossa Internazionale
نړيوالتوب	Globalizzazione
ناټو	Organizzazione del Trattato dell'Atlantico del Nord
جين	Gene
حکومت	Governo
نوبل جايزه	Premio Nobel
چېن شي هوانگ	Qin Shi Huang
منځنی ختيځ	Medio Oriente
رنځپوهنه	Patologia
رابندرانات ټاگور	Rabindranath Tagore
لېو نيكولايوويچ تولستوى	Lev Tolstoj
مارک ټوېن	Mark Twain
ايډيالوژي	Ideologia
ادا لولېس	Ada Lovelace
مارکسيزم	Marxismo
ولسمشريزه	Repubblica
دولت	Stato
گوند	Partito politico
بډمنټن	Badminton
يوري الکسويچ گاگارين	Jurij Gagarin
ابن بطوطه	Ibn Battuta
اباسين (سيند)	Indo
فرانز جوزیف هایدن	Franz Joseph Haydn
غوږ	Orecchio
سترگه	Occhio
سندره	Canzone
اوښ	Camelus
تی لرونکی ځناوران	Mammalia
مېږی	Formicidae
مارگريت تاچر	Margaret Thatcher
ډي آکسي رايبونيوکليک اسيد	DNA
ژباړه	Traduzione
ښامار	Drago
مور	Madre
پلار	Padre
لېږدچارې	Trasporto
روسي ژبه	Lingua russa
ولادمير پوتين	Vladimir Putin
حقوق	Diritto
اساسي قانون	Costituzione
د بشري حقونو نړېواله اعلاميه	Dichiarazione universale dei diritti umani
د روغتيا نړيوال سازمان	Organizzazione mondiale della sanità
د سوداگرۍ نړيوال سازمان	Organizzazione mondiale del commercio
پرېولنځی	Water
طبيعت	Natura
سادرملنه	Psichiatria
ژونکه	Cellula
وينه	Sangue
هډوانه	Scheletro (anatomia)
سږي	Polmone
ساييز غونډال	Apparato respiratorio
رومانيايي ژبه	Lingua romena
بلغاريايي ژبه	Lingua bulgara
ښوونپوهنه	Didattica
روزنپوهنه	Pedagogia
يمال	Valanga
رېږدله	Terremoto
طبيعي پوهنې	Scienze naturali
ابن سينا بلخي	Avicenna
وېنسټون چرچل	Winston Churchill
نېلسن مانډېلا	Nelson Mandela
انزايم	Enzima
امينو اسيد	Amminoacido
ورېځ	Nuvola
سولپوهنه	Logica
مېچپوهنه	Geometria
وټپوهنه	Economia
پانگه (وټپوهنه)	Capitale (economia)
ارز	Valuta
رغاوه	Industria
ورکړېنه	Imposta
ژبپوهنه	Linguistica
يوناني ابېڅې	Alfabeto greco
ادبپوهنه	Letteratura
وېشنيزه:فرانسه	Categoria:Francia
ناول	Romanzo
سره گيدړه	Vulpes vulpes
اوستراوا	Ostrava
کوروش ۲	Ciro II di Persia
ټولنه	Società (sociologia)
تمدن	Civiltà
زده کړه	Educazione
هوگو چاوېز	Hugo Chávez
واده	Matrimonio
وگړنيز حقوق	Diritti umani
توکمپالنه	Razzismo
گوډ تېمور	Tamerlano
عمر بن خطاب	ʿUmar ibn al-Khaṭṭāb
پوځ	Militare
سلیمان ۱	Solimano il Magnifico
قهوه	Caffè
د آمو سيند	Amu Darya
شيدې	Latte
ارغنداب رود	Arghandab
غر	Montagna
هري رود	Hari Rud
هلمند رود	Helmand (fiume)
توكبنسټ	Base di dati
کابل سيند	Kabul (fiume)
صلاح الدين ايوبي	Saladino
اشوک	Ashoka
جلال الدين محمد اکبر	Akbar
هانگ کانگ	Hong Kong
کراچۍ	Karachi
د ريال مادريد فوټبال کلب	Real Madrid Club de Fútbol
سيول	Seul
شانگهای	Shanghai
د ماد واکمني	Medi
اقليدس	Euclide
بايټ	Byte
محمد بن موسی خوارزمي	Muhammad ibn Musa al-Khwarizmi
ناروېژي ژبه	Lingua norvegese
نوم چومسكي	Noam Chomsky
چيکی ژبه	Lingua ceca
کارل مارکس	Karl Marx
موسی	Mosè
پوهه	Conoscenza
هندويزم	Induismo
اټوم	Atomo
يوناني ژبه	Lingua greca
چليز غونډال	Sistema operativo
تاج محل	Taj Mahal
بنسټپالنه	Fondamentalismo
برېښليک	Posta elettronica
پاړسي ژبه	Lingua persiana
مذهب	Religione
اېمپاير سټېټ ودانۍ	Empire State Building
سېگمونډ فرايډ	Sigmund Freud
جاينيزم	Giainismo
گيورگ ويلهېلم فرېدرېش هېگل	Georg Wilhelm Friedrich Hegel
باکو	Baku
تاجکي ژبه	Lingua tagica
اوزبکي ژبه	Lingua uzbeca
تورکمني ژبه	Lingua turkmena
يهوديت	Ebraismo
آزربايجاني ژبه	Lingua azera
ابن خلدون	Ibn Khaldun
امانوېل کانت	Immanuel Kant
سکيزم	Sikhismo
فرېدرېک وېلهېلم نېتشي	Friedrich Nietzsche
بشکیک	Biškek
دوشنبه	Dušanbe
اينه	Fegato
پښتورگی	Rene
ادم سمېت	Adam Smith
احساس	Emozione
ساپوهنه	Psicologia
آند	Pensiero
مهاوېرا	Mahavira
سمندر	Oceano
ملکه وېکټوريا	Vittoria del Regno Unito
محمد	Maometto
اخلاق	Etica
پوهنپوهنه	Epistemologia
سچين رمېش ټنډولکر	Sachin Tendulkar
عبدالکلام	Abdul Kalam
بي بي سي	BBC
شاهرخ خان	Shah Rukh Khan
سلمان خان	Salman Khan
محمد الغزالي	Al-Ghazali
عامر خان	Aamir Khan
اميتاببچن	Amitabh Bachchan
شيعه	Sciismo
گېډه	Addome
زرتشتيت	Zoroastrismo
تصوف	Sufismo
ژبه (اناتومي)	Lingua (anatomia)
پانکراس	Pancreas
غاړه	Collo
کمزوره شوي یورانیم	Uranio impoverito
هولي	Holi
زړه پوهنه	Cardiologia
ډېوېډ بکهم	David Beckham
کيم جونگ ايل	Kim Jong-il
وېشنيزه:وېنزوېلا	Categoria:Venezuela
روبېرت موگابي	Robert Mugabe
خاپوړن	Reptilia
کوتره	Columbidae
باکټريا	Bacteria
ونه	Albero
دوه ژوندوي	Amphibia
اوښتون	Rivoluzione
انگور	Uva
گبين	Miele
کچالو	Solanum tuberosum
سابه	Verdura
ټکنالوجي	Tecnologia
انجينري	Ingegneria
خبريالي	Giornalismo
ورځپاڼه	Giornale
غږلېږدی	Telefono
هڅوب	Cultura
سانسکریت ژبه	Lingua sanscrita
د زړه او رگونو غونډال	Apparato circolatorio
د پارکېنسون ناروغي	Malattia di Parkinson
گارډيان	The Guardian
انډيپېنډنټ	The Independent
درملگري	Medicina
مقننه قوه	Potere legislativo
مايکروسافټ آفېس	Microsoft Office
وېشنيزه:رومانیا	Categoria:Romania
کيمياوي توکی	Elemento chimico
ابن باجه	Ibn Bajja
هورمون	Ormone
اپارتايد	Apartheid
جودو	Judo
مقناطيس	Magnete
فلم	Film
ساهيالي	Animazione
کرنه	Agricoltura
غږ	Suono
نانو تکنالوژي	Nanotecnologia
ښيښه	Vetro
وخت	Tempo
ليکپاڼه	Carta
کازمېکي وړانگې	Raggi cosmici
جوار	Zea mays
انځورکښنه	Pittura
تشیالیونی	Astronauta
انځوراخيستنه	Fotografia
برېښنايي ټېکنالوژي	Elettronica
فريکونسي	Frequenza
خوړنځی	Ristorante
د لودیانو ټولواکمني	Dinastia Lodi
لاهور	Lahore
د خپلواکو هېوادونو لړليک	Stati del mondo
ابوريحان بيروني	Al-Biruni
څېړۍ	Quercus
کولرا	Colera
غنم	Triticum
ناروغي	Malattia
گرېگوري کليز	Calendario gregoriano
نیکوتین	Nicotina
روغتيا	Salute
ملاريا	Malaria
انټيبايوټيک	Antibiotico
پنسلين	Penicillina
نېمونيا	Polmonite
گوزڼ	Poliomielite
اېډز	AIDS
نری رنځ	Tubercolosi
ډايبېټېز مېلېټوز	Diabete mellito
صليبي جگړې	Crociata
منځنۍ پېړۍ	Medioevo
عثماني پېر	Impero ottomano
د کورنيو توليداتو ټوليز ارزښت	Prodotto interno lordo
برېښنا	Elettricità
یان آموس کمېنسکي	Comenio
اټومي برېښناکوټ	Energia nucleare
د بړاس ماشين	Motore a vapore
توره (وسله)	Spada
هستوي وسلې	Arma nucleare
شوبله	Carro armato
هرمان ون رومپوې	Herman Van Rompuy
ناريال	Cocos nucifera
انار	Punica granatum
مالټه	Citrus × sinensis
A New Etymological Vocabulary of Pashto	Kiwi (frutto)
گراڅ	Graz
ډېبټ کارډ	Carta di debito
انجلينا جولي	Angelina Jolie
عربي ژبه	Lingua araba
کانډوم	Profilattico
تيرانوسور	Tyrannosaurus rex
تریسراتوپس	Triceratops
ستگوسور	Stegosaurus
وچکښ	Matita
برنو	Brno
هوجينتاو	Hu Jintao
د شوروي سوسياليستي جمهوريتونو اتحاد	Unione Sovietica
انځورۍ	Fotocamera
اېچ آی وي	HIV
يومکی	Scapola
ځاني سولگر	Personal computer
بروس لي	Bruce Lee
هايپوتايرايډيزم	Ipotiroidismo
نړۍ	Mondo
د روم جمهوريت	Repubblica romana
ټریلوبیټ	Trilobita
گردکه	Circonferenza
گرځنده غږلېږدی	Telefono cellulare
اوښمرغه	Struthio camelus
بغ	Ardeidae
پيونگيانگ	Pyongyang
د لور موندنې نړيوال غونډال	Sistema di Posizionamento Globale
د هېوادونو لړليک د کورنيو توليداتو د ټوليز ارزښت له مخې	Stati per PIL (nominale)
جگتورن	Capitano
سمندري غڼې	Pycnogonida
لړم	Scorpiones
ما اينگ جيو	Ma Ying-jeou
سمندري لړمان	Eurypterida
انټرنټ لټوونکی ماشين	Motore di ricerca
بخارست	Bucarest
لوور	Museo del Louvre
تیرانا	Tirana
ويکټوريا بېکهم	Victoria Beckham
درېڅنډی	Triangolo
سټيف جوبز	Steve Jobs
معمر القذافي	Mu'ammar Gheddafi
پړانگ	Panthera tigris
لومړی خوان کارلوس	Juan Carlos I di Spagna
مېچې	Vermicelli
لمسنالۍ	Touchpad
سامسونگ	Samsung
سولگرپوهنه	Informatica
ټولنپوهنه	Sociologia
گاگره	Calcestruzzo
جغرافي کوراډينېټونو سيستم	Coordinate geografiche
پڼې	Scarpa
بهايي	Bahá'í
بانک	Banca
د وينا ازادي	Libertà di parola
اډېل	Adele (cantante)
د نش ميزان	Equilibrio di Nash
هوږه	Allium sativum
وگړپوهنه	Antropologia
بادرنگ	Cucumis sativus
ارنېست مېلر هېمېنگوې	Ernest Hemingway
عشق آباد	Aşgabat
ټاپو	Isola
تور (رنگ)	Nero
پياز	Allium cepa
رسمي ژبه	Lingua ufficiale
لرغونپوهنه	Archeologia
بالکان	Penisola balcanica
سلاوي ژبې	Lingue slave
سر	Testa
ولسي لاره	Inno nazionale
تماسي عدسيه	Lente a contatto
الفرېډ نوبل	Alfred Nobel
ږمنځ	Pettine
لیلا داونز	Lila Downs
موسم	Stagione
راولپنډۍ ولسوالۍ	Distretto di Rawalpindi
ډبرين سکاره	Carbone
يارمخچۍ	Calandrella brachydactyla
نينورشک	Nynorsk
بوکمول	Bokmål
کونگ	Strigiformes
شمزۍ لرونکي ژوي	Vertebrata
نړېوال تشيال تمځای	Stazione Spaziale Internazionale
ISO 3166-1	ISO 3166-1
کجوره	Phoenix dactylifera
څټک	Martello
اروپايي کاغۍ	Pica pica
چابکۍ	Blattodea
كوچنى شاهزاده	Il piccolo principe
شمالي باز	Accipiter gentilis
غضروفی کبان	Chondrichthyes
ځنگلي سار	Buteo buteo
سيلاني کارغه	Corvus frugilegus
لويديځي کاغۍ	Coloeus monedula
شودپۍ	Motacilla alba
اېشېريکيا کولي	Escherichia coli
توتکۍ	Hirundo rustica
گنگو	Zafferano (spezia)
ترکاڼک	Picidae
شامتوره	Sturnus vulgaris
کوشانيان	Impero Kusana
کومکۍ	Columba palumbus
جوک	Linaria cannabina
آتروپين	Atropina
شين شارک	Prionace glauca
اورني سمندر	Salamandra salamandra
سپوږمکۍ	Satellite artificiale
شينغاړی	Luscinia svecica
تورياڼۍ	Apodidae
لونگ	Syzygium aromaticum
زيره	Carum carvi
وژونکی نهنگ	Orcinus orca
سپېرکونده	Galerida cristata
منځنۍ آسيا	Asia centrale
شمالي افريقا	Nordafrica
مرکزي افريقا	Africa centrale
ختيځه اروپا	Europa orientale
لوېديځه اروپا	Europa occidentale
افريقايي اوراسيا	Eurafrasia
زي نړیواله جگړه (فلم)	World War Z
مړز	Coturnix coturnix
مروری	Matricaria chamomilla
کمول (مارغه)	Ciconiidae
اوبدانه	Tessuto
توکي	Merce
سپوږميز ليږديز کليز	Calendario islamico
ميلوش زېمان	Miloš Zeman
اېف-۱۵	McDonnell Douglas F-15 Eagle
ليوکېمي	Leucemia
ديموکراتيک گوند ( د امريکا متحده ایالتونه)	Partito Democratico (Stati Uniti d'America)
ټيکاله	Alaudidae
شاتو مچی	Apis mellifera
خاورين چينجی	Lumbricus terrestris
ولسمشر	Presidente
باشه	Falco peregrinus
رودولف کلاوزيوس	Rudolf Clausius
تورغوږی	Caracal caracal
ډېل	Dell
زايلومېټازولين	Xilometazolina
شمېرنی	Calcolatrice
امير عبدالرحمان خان	Abdur Rahman Khan
د عربستان ټاپووزمه	Penisola araba
امير دوست محمد خان	Dost Mohammed
بېریف بې-۲۰۰	Beriev Be-200
پهلوي ژبه	Lingua pahlavi
وری	Ariete (astrologia)
بردسکن ولسوالۍ	Provincia di Bardeskan
جېهلم ولسوالۍ	Distretto di Jhelum
ملاله يوسفزۍ	Malala Yousafzai
جومات	Moschea
بلوڅی ژبه	Lingua baluchi
د کتاب نړيواله کره شمېره	ISBN
د مغولو پاچايي	Moghul
گړدود	Dialetto
ایرانی ژبی	Lingue iraniche
هېما مالېني	Hema Malini
لاس	Mano
خلکو شمېر	Popolazione
پاڼه	Foglia
لوبگر	Attore
هاليووډ	Hollywood
محمد حسنی مبارک	Hosni Mubarak
دينپوهنه	Teologia
پابلو نرودا	Pablo Neruda
زیوس	Zeus
موساد	Mossad
یغنابی ژبه	Lingua yaghnobī
انجيل	Vangelo
الېکسانډر گراهام بېل	Alexander Graham Bell
ستورپېژندنه	Astrologia
ساز	Strumento musicale
ويټني هيوسټن	Whitney Houston
سابون	Sapone
موشوفتسی	Mošovce
شکيرا	Shakira
محمود احمدي نژاد	Mahmud Ahmadinejad
كېښكلى ټيكلى (CD)	Compact disc
چورلکه	Elicottero
القاعده	Al-Qaida
محمد فاتح	Maometto II
اناستاسيا	Anastacia
فرات	Eufrate
البېرټ کامو	Albert Camus
د فارس خليج	Golfo Persico
قطب نما	Bussola
ټولنيزې پوهنې	Scienze sociali
ټاپووزمه	Penisola
نوی کال	Capodanno
اېف-۱۴	Grumman F-14 Tomcat
ويټامين	Vitamine
تورات	Torah
كرم	Brassica oleracea var. capitata
متل	Proverbio
هينداره	Specchio
لرغونې پاړسي	Lingua persiana antica
عربان	Arabi
براډ پېت	Brad Pitt
کړکۍ	Finestra
اکدي ژبه	Lingua accadica
څارندوی	Polizia
ولسي جرگه	Parlamento
اوساکا	Osaka
د کېمبرېج پوهنتون	Università di Cambridge
اجرايي قوه	Potere esecutivo
تعمید غسل	Battesimo
ډډون	Inflazione
سابندي	Asma
عمر خيام	ʿUmar Khayyām
وله	Salix
محمد علي کلي	Muhammad Ali
خاوره	Suolo
اينځر	Ficus carica
ليکوال	Scrittore
د توهوکو سونامي او رېږدله ۲۰۱۱	Terremoto e maremoto del Tōhoku del 2011
واتسلاف هاول	Václav Havel
د ورېښم لار	Via della seta
جېن آسټن	Jane Austen
کوردي ژبه	Lingua curda
زرۍ	Millennio
علمی نوم	Nomenclatura binomiale
هنرېک ايبسن	Henrik Ibsen
ماموت	Mammuthus
څلورڅنډی	Quadrilatero
د سرکوزي والگی	Influenza suina
اوزون	Ozono
جذام	Lebbra
مخ (اناتومي)	Viso
خپلواکي	Indipendenza
ښوون	Olea europaea
سليمان	Salomone
یاهو!	Yahoo!
کرښه (مېچپوهنه)	Retta
فرعون	Faraone
کلاشېنکوف اې کې ۴۷	AK-47
څپه	Onda
د وینې سره کرویات	Eritrocita
سند	Sindh
فرانسېس بیکن	Francesco Bacone
معمولي مندته	Prunus armeniaca
نيکول کېډمېن	Nicole Kidman
هايکو	Haiku
عثمان بن عفان	Othmàn ibn Affàn
وگړشمېرنه	Demografia
ځمکواکي	Feudalesimo
اوبړۍ	Alga
نتالي پورټمېن	Natalie Portman
هېرټا مولر	Herta Müller
مکډونالډز	McDonald's
يوکوهوما	Yokohama
گړپوهنه	Morfologia (linguistica)
ويليم فاکنر	William Faulkner
هندواڼه	Citrullus lanatus
پخلی	Cottura
بادي ژرنده	Mulino a vento
د حماس اسلامي غورځنگ	Hamas
آيت الله روح الله خميني	Ruhollah Khomeyni
ليزر	Laser
تبه	Febbre
تيد	Teide
کوچنی وټه	Microeconomia
رجب طيب اردوغان	Recep Tayyip Erdoğan
خزدکپوهنه	Entomologia
تبر	Scure
علي بن ابي طالب	Ali ibn Abi Talib
گورجی سپی	Setter
لویه وټه	Macroeconomia
انسولين	Insulina
بازارموندنه	Marketing
سرشمېرنه	Censimento
ابن رشد	Averroè
لسيزه	Decennio
بادام	Prunus dulcis
څښاک	Bevanda
نيانډرټال	Homo neanderthalensis
الهي کمېډي	Divina Commedia
ووب	Tessuto (biologia)
پروېز مشرف	Pervez Musharraf
لوط	Lot
دهاډرونو ستر تعجیل کوونکي ماشین	Large Hadron Collider
يحيی	Giovanni Battista
دیلما روسف	Dilma Rousseff
ساندرا بللاک	Sandra Bullock
جراحي	Chirurgia
بياتي	Forbici
نفرتيتي	Nefertiti
لمونځ	Preghiera
سکايپ	Skype
غږپوهنه	Fonologia
هارولډ پينټر	Harold Pinter
د حزب الله اسلامی غورځنگ	Hezbollah
باو	Sifilide
د آشور واکمني	Assiria
ودانۍ	Edificio
سوني	Sony
باريس ولاديميروويچ پاسترناک	Boris Pasternak
کونستانتين اېدواردوويچ تسيولکوفسکي	Konstantin Ėduardovič Ciolkovskij
سينما	Sala cinematografica
بودجه	Budget
څپواټن	Lunghezza d'onda
داوود	Davide
کنگل هاکي	Hockey su ghiaccio
کوردستان	Kurdistan
د موس مقياس	Scala di Mohs
بواسيرونه	Emorroidi
هېنريک سېنکېويچ	Henryk Sienkiewicz
ککرۍ پتنگ	Acherontia atropos
كوكايين	Cocaina
فینیکیان	Fenici
شهادت	Shahada
د بابل ځوړند بڼ	Giardini pensili di Babilonia
حاکميت	Sovranità
خديجه بنت خويلد	Khadija bint Khuwaylid
ام سلمه هند بنت ابي اميه	Umm Salama Hind bint Abi Umayya
نیلي نهنگ	Balaenoptera musculus
څېړنه	Ricerca scientifica
سولي پرودممه	Sully Prudhomme
اوبپوهنه	Idrologia
بوکر	Cono
د مورنۍ ژبې نړيواله ورځ	Giornata internazionale della lingua madre
سهيونېزم	Sionismo
د طالبانو اسلامي غورځنگ	Talebani
اناکزیمېنډر	Anassimandro
کورکمن	Curcuma longa
ځنگلي پيشو	Felis chaus
عبدالله گل	Abdullah Gül
کرېشنا	Krishna
ساباوري	Animismo
ليکچه	Taccuino
مالیه	Finanza
وچکالي	Siccità
تور مرچ	Piper nigrum
ياقوت	Rubino
کشمير	Kashmir
ټولپوښتنه	Referendum
كپېړ	Crocodylidae
مولانا جلال الدين محمد بلخي	Gialal al-Din Rumi
کارغه	Corvus
پلزن	Plzeň
توکمپوهنه	Etnologia
مټ	Braccio
زمرد	Smeraldo
وحشي پيشو	Felis silvestris
شکرخوره	Trochilidae
فدراسيون	Stato federale
شونډکيز چرگ	Meleagris
انسلم	Anselmo d'Aosta
حامد کرزی	Hamid Karzai
یان هوس	Jan Hus
کورني آلو	Prunus domestica
اندرس بېرينگ برېويک	Anders Breivik
شينټاغی	Coraciidae
احمد سلمان رشدي	Salman Rushdie
افسانه	Leggenda
داریوش ۱	Dario I di Persia
توت	Morus (botanica)
لسبېله ولسوالۍ	Distretto di Lasbela
اېنټروپي	Entropia
ټوبه ټيک سېنگ ولسوالۍ	Distretto di Toba Tek Singh
گجرات ولسوالۍ	Distretto di Gujrat
هرات	Herat
کودتا	Colpo di Stato
کندهار	Kandahar (città)
تړمه ييزه پراختیا	Coefficiente di dilatazione termica
غشی	Freccia
غږتاندی	Microfono
ابن عربي	Ibn Arabi
اپيم	Oppio
اوسيريس	Osiride
ازاد بازار	Libero mercato
اوکاړه ولسوالۍ	Distretto di Okara
احمد شاه دراني	Ahmad Shah Durrani
اسراييل لرغونتون	Israel Museum
جي اس ام	Global System for Mobile Communications
اېشواريه رای	Aishwarya Rai
نوغپوهنه	Genealogia
مېلټون فرايډمېن	Milton Friedman
بانکنوټ	Banconota
نړيواله جنايي محکمه	Corte penale internazionale
رادار	Radar
د اسلامي همکاريو سازمان	Organizzazione della cooperazione islamica
سياسي وټه	Economia politica
د بابل واکمني	Civiltà babilonese
جبران خليل جبران	Khalil Gibran
روبي وېليمز	Robbie Williams
د سږو سرطان	Carcinoma del polmone
مهايانا	Buddhismo Mahāyāna
امريتسر	Amritsar
اس ـ ۳۰۰	S-300
مير تشيال تمځی	Mir (stazione spaziale)
خانيوال ولسوالۍ	Distretto di Khanewal
لنډه کيسه	Racconto
د لبنان جگړه ۲۰۰۶	Guerra del Libano (2006)
گرځندويي	Turismo
شاعر	Poeta
یوسېفینه پرویس	Josefine Preuß
يو گونديز حکومت	Monopartitismo
مصري ژبه	Lingua egizia
هارون	Aronne
ایبولا ناروغۍ	Malattia da virus Ebola
ژونځمکپوهنه	Biogeografia
غونډ	Reggimento
سور كانگرو	Macropus rufus
هارپي	Harpia harpyja
ابسيډين	Ossidiana
وېشنيزه:حکومت	Categoria:Governo
د کيلو کلاس اوبتل	Classe Kilo
سپايس گرلز	Spice Girls
مېزپاسی سولگر	Computer desktop
پاراستامول	Paracetamolo
عبدالله بن عبدالعزیز آل سعود	Abd Allah dell'Arabia Saudita
سيد على خامنه‌اى	Ali Khamenei
امام علي رحمانوف	Emomali Rahmon
اودو فوګت	Udo Voigt
اسلام کريموف	Islom Karimov
راجا پروېز اشرف	Raja Pervaiz Ashraf
گيودو ويسترويلي	Guido Westerwelle
پښتو ژبه	Lingua pashtu
عرب سمندرگی	Mar Arabico
گرمټ	Trapano
دیو جانس کلبی	Diogene di Sinope
کورنت توغندی	Kornet
هېرويين	Eroina
کوفین	Caffeina
اندروجن	Androgeno
سيمټيکس	Semtex
راوړنې	Importazione
ببرک کارمل	Babrak Karmal
حفيظ الله امين	Hafizullah Amin
يوسف عبدالله القرضاوي	Yusuf al-Qaradawi
تريخی	Cistifellea
انتوني هوپکينز	Anthony Hopkins
مرکزي بانک	Banca centrale
جيپور	Jaipur
سيبري پړانگ	Panthera tigris altaica
القلويد	Alcaloidi
آدم	Adamo
یوسيف ۲	Giuseppe II d'Asburgo-Lorena
تره	Zio
کریستوف والڅ	Christoph Waltz
عبدالاحد مومند	Abdul Ahad Momand
ښاري انجنيري	Ingegneria civile
وړانگپوهنه	Radiologia
اليگارشي	Oligarchia
زړه گراف	Elettrocardiogramma
د افغانستان رپی	Bandiera dell'Afghanistan
ايسيس	Iside
ځوانکې	Acne
اېترنټ	Ethernet
چکوتره	Citrus maxima
بشري پوهنې	Discipline umanistiche
ټپوس	Milvus migrans
نهنگی شارک	Rhincodon typus
بېنډۍ	Abelmoschus esculentus
د سلطان احمد جومات	Moschea Blu
اټومي بټۍ	Reattore nucleare a fissione
مايکروسافټ اوټلوک	Microsoft Outlook
بنگالي پړانگ	Panthera tigris tigris
مالداري	Allevamento
معمولي کپر (کب)	Cyprinus carpio
اولوموڅ	Olomouc
مورفين	Morfina
د صرافی ماشین	Automated Teller Machine
نخود	Cicer arietinum
نوح	Noè
والټ وايټمېن	Walt Whitman
غاښۍ	Forchetta
چوپسټېک	Bacchette per il cibo
د خوړو او کرهڼې سازمان	Organizzazione delle Nazioni Unite per l'alimentazione e l'agricoltura
براشوف	Brașov
زنه	Mento
قطبي گيدړ	Alopex lagopus
سياستوال	Politico
شپږڅنډی	Esagono
د افغانستان جگړه (۱۹۷۹-۱۹۸۹)	Guerra in Afghanistan (1979-1989)
ختيځ هند کمپنۍ	Compagnia britannica delle Indie orientali
الكساندر نيكولاېويچ رومانوف	Alessandro II di Russia
اسکلېپيوس	Asclepio
ژان اېف کوستو	Jacques-Yves Cousteau
وزير (حکومت)	Ministro
گرو نانک	Guru Nanak Dev
کانپوهنه	Mineralogia
شېنگن تړون	Accordi di Schengen
سابه خوړونکي	Vegetarianismo
امپيدوکلېس	Empedocle
اوېستا	Avestā
ستر جنرال	Generale
شاه جهان	Shah Jahan
د الله نومونه	Nomi di Dio nel Corano
د ساسانيانو واکمني	Sasanidi
هوروس	Horus
پولنډبال	Polandball
راټکو مېلادېچ	Ratko Mladić
انځورگري	Disegno
پرېژه	Divorzio
باليووډ	Bollywood
اېف – ۱۶	General Dynamics F-16 Fighting Falcon
عبدالله کلا ولسوالۍ	Distretto di Killa Abdullah
کلوژ-ناپوکا	Cluj-Napoca
مرزا حسين علي بهاالله	Bahá'u'lláh
نېغ انسان	Homo erectus
ماهر انسان	Homo habilis
هاډرون	Adrone
سوسن	Convallaria majalis
اينو	Ainu
تسپود	Infiammazione
بايوم	Bioma
لروين	Binocolo
گبين مچۍ	Apis
آوسټرالوپیتهېکوس	Australopithecus
نړېواله جگړه	Guerra mondiale
روي شنکر	Ravi Shankar
چندرۍ	Humulus lupulus
کرښی	Riga (strumento)
قضايي قوه	Potere giudiziario
ماگنوس کارلسن	Magnus Carlsen
مرزا اسد الله خان غالب	Mirza Ghalib
خاښۍ	Forca (attrezzo)
ايالت	Stato federato
کندوز	Konduz
انجه	Ferula assa-foetida
مارشال	Maresciallo
انټيکولينرجيک	Anticolinergico
مالي کړکېچ	Crisi finanziaria
هزاره گان	Hazara
سليكان ډای اکسايډ	Silice
د وېلسن ناروغي	Malattia di Wilson
ابن قيم الجوزي	Ibn Qayyim al-Jawziyya
الكساندر الكساندروويچ رومانوف	Alessandro III di Russia
بلخ ولايت	Balkh
مشهد	Mashhad
رنځورپالنه	Assistenza infermieristica
پاکپتن ولسوالۍ	Distretto di Pakpattan
ټولنیزه ولسواکي	Socialdemocrazia
د ستنې طب	Agopuntura
سفارت	Ambasciatore
کجير	Avvoltoio
عقيق	Agata (minerale)
اپلاتون او دولت	La Repubblica (dialogo)
ارستوکراسي	Aristocrazia
زکات	Zakat
ميرمشاه	Miranshah
گيورگې ژوکوف	Georgij Konstantinovič Žukov
د اوبو چينه	Sorgente (idrologia)
بڼ پالنه	Giardinaggio
وېليم جېمز	William James
غوڅندۍ	Sega (strumento)
سورلنډی	Sciacallo
د موسم بدلون	Mutamento climatico
واټن	Distanza (matematica)
کوباني	Kobanê
پراگماتيزم	Pragmatismo
وړکتون	Scuola dell'infanzia
ابن ميمون	Mosè Maimonide
شين یاقوت	Zaffiro
پينځڅنډی	Pentagono
ټوټالېټر	Totalitarismo
کوچيان	Popoli nomadi
درملپوهنه	Farmacologia
د زیات شوي ارزښت ورکړېنه	Imposta sul valore aggiunto
خټنه	Viscosità
لوي سپين شارک	Carcharodon carcharias
د جمشید پلاز	Persepoli
انتراکس	Antrace
خشايارشا	Serse I di Persia
مزار شريف	Mazar-i Sharif
مېگ ۲۹	Mikoyan-Gurevich MiG-29
د ذرو تعجيل کوونکي ماشين	Acceleratore di particelle
ډیمېټروډون	Dimetrodon
سپاینوسور	Spinosaurus
بېیپیاوساوروس	Beipiaosaurus inexpectus
خلافت	Califfato
معمولي آلوبالو	Prunus cerasus
زغوپرواژی	Pesticida
ډومنيک ډي وېلپين	Dominique de Villepin
د قم ولايت	Regione di Qom
گڼرسنۍ	Multimedialità
کوروند	Corindone
سریښ	Colla
والي	Governatore
توکمکښنه	Etnografia
کرما په هندويزم کې	Karma
آيورويدا	Ayurveda
د جال تړونونه	Protocollo di comunicazione
جوليوس روبرټ اوپنهايمر	Robert Oppenheimer
باختر	Battria
هېروگليف	Geroglifici egizi
ولاديمير ولاديميروويچ ماياکوفسکي	Vladimir Vladimirovič Majakovskij
د هند پېښليک	Storia dell'India
مستعمره	Colonia (insediamento)
ملخوزه	Trigonella foenum-graecum
اخوان المسلمون	Fratelli Musulmani
تومور	Neoplasia
الياس	Elia
طاعون	Peste
د سېټريک اسيد څرخ	Ciclo di Krebs
دهرما	Dharma
ټاسماني شيطان	Sarcophilus harrisii
توپاز	Topazio
۹×۱۹ مرمی	9 × 19 mm Parabellum
قادريه	Qadiriyya
د ايران ولسوالۍ	Province dell'Iran
ابد	Eternità
عبدالعلي مزاري	Abdul Ali Mazari
زابل ولايت	Zabol
زکريا	Zaccaria (Nuovo Testamento)
مسراشمیت مې-۲۶۲	Messerschmitt Me 262
ازاد شعر	Verso libero
شگموښی	Carta abrasiva
ايليوشين-۷۶	Ilyushin Il-76
فرایشتات	Freistadt
زينب بنت خزيمه	Zaynab bint Khuzayma
زينب بنت جحش	Zaynab bint Jahsh
هربرټ سپېنسر	Herbert Spencer
سارک	Associazione sud-asiatica per la cooperazione regionale
يوسف	Giuseppe (patriarca)
د لويديځ سلاوي ژبې	Lingue slave occidentali
اروپايي صنوبر	Picea abies
شين صنوبر	Picea pungens
چمبل	Viola (botanica)
پولي ونيل کلورايډ	Cloruro di polivinile
نانگه	Ribes rubrum
قبطيان	Copti
ټاټرا ۸۱۷	Tatra T815-7
نارنج	Citrus × aurantium
اناناس	Ananas
کاجول	Kajol
ايگلا	Igla (missile)
ځنگلي مېږی	Formica rufa
مېگ ۳۱	Mikoyan MiG-31
پښيميسل اوتاکار ۲	Ottocaro II di Boemia
رودلف ۲ هابسبورگ	Rodolfo II d'Asburgo
ميانې	Dhu l-Qa'da
عبد العزيز بن عبدالرحمن بن فيصل آل سعود	Abd al-Aziz dell'Arabia Saudita
دېوالي	Bancarotta
بوغمه	Edema
محمد ظاهر شاه	Mohammed Zahir Shah
ډگر جنرال	Tenente generale
بريد جنرال	Generale di brigata
سيف الله کلا ولسوالۍ	Distretto di Killa Saifullah
البرخت فون والدشتاین	Albrecht von Wallenstein
امير امان الله خان	Amānullāh Khān
عمران خان	Imran Khan (politico)
یان لوگزامبورگ	Giovanni I di Boemia
روهتاس	Forte Rohtas
جيارډيا لامبليا	Giardia lamblia
ميل می ۸	Mil Mi-8
مېسرشمېت بي اف ۱۰۹	Messerschmitt Bf 109
مسراشمیت بي اف ۱۱۰	Messerschmitt Bf 110
یوزي	IMI Uzi
ريچارډ هولبروک	Richard Holbrooke
ميل می ۲۴	Mil Mi-24
ايساف	International Security Assistance Force
ټې-۷۲	T-72
یونکرس یو ۸۸	Junkers Ju 88
کارل ۴	Carlo IV di Lussemburgo
مېگ ۲۳	Mikoyan-Gurevich MiG-23
ارهنډه	Ricinus communis
اېرو ال-۳۹ الباتروس	Aero L-39 Albatros
نېښ لرونکي بوټي	Urtica dioica
ټېنوفووير	Tenofovir
د آلمان ملي دموکراتیک گوند	Partito Nazionaldemocratico di Germania
رشقه	Medicago sativa
لتا منگېشکر	Lata Mangeshkar
سره غوړیانه	Lilium martagon
ادميرال پتنگ	Vanessa atalanta
فيض آباد (بدخشان)	Feyzabad
ځريځه	Carthamus tinctorius
تورن جنرال	Maggior generale
گزک بوټي	Plantago lanceolata
ال – ۴۱۰	Let L 410
تبو	Tabu (attrice)
غوماشی	Anopheles
د افغانستان ولايتونه	Province dell'Afghanistan
تاووس پتنگ	Inachis io
جوهي چاولا	Juhi Chawla
پريانکا چوپړا	Priyanka Chopra
ويديا بالان	Vidya Balan
لاکهيډ مارتين آر کيو ۱۷۰ سېنټينل	Lockheed Martin RQ-170 Sentinel
ناصر الدين شاه قاجار	Nasser al-Din Shah Qajar
د اس وې ډې دراگونوف ټوپک	SVD Dragunov
یرژي پوديېبراد	Giorgio di Boemia
د ځمکې گړۍ	Ora della Terra
رام	Rama
محمد علی جناح	Mohammad Ali Jinnah
وچکۍ تبه (محرقه)	Tifo esantematico
اتره	Tronco (anatomia)
توت خوره	Fringillidae
شاتوت	Morus nigra
ښاريتوب	Urbanizzazione
غونجېدنه (وټپوهنه)	Deflazione (economia)
خپلپالنه	Nepotismo
باور کارټ	Carta di credito
پامير	Pamir
وېلنی	Mentha longifolia
سيسۍ	Lagopus
سرطانپوهنه	Oncologia
گلايکوليسېز	Glicolisi
شکودا فابيا	Škoda Fabia
گایوس واليریوس کاتولوس	Gaio Valerio Catullo
بلوچستان (پاکستان)	Belucistan (Pakistan)
غالۍ	Tappeto
موزيکپوهنه	Musicologia
ليندۍ	Capricorno (astrologia)
ابسه	Ascesso
گانډۍ	Arnia
کدو	Zucca
د کرمان ولايت	Regione di Kerman
بدخشان ولايت	Badakhshan
اتڅنډی	Ottagono
مچ	Musca domestica
وړانديز (وټپوهنه)	Domanda e offerta
پارلماني حکومت	Sistema parlamentare
برغټ	Felis manul
نگوس	Stereotipo
نورستان ولايت	Provincia di Nurestan
محمد قسيم فهيم	Mohammed Fahim
ډولومیت	Dolomite
جابر بن حیان	Jabir ibn Hayyan
بورقه	Burqa
کرايووا	Craiova
کورکوری	Streptopelia turtur
روحانيت	Spiritualità
انافلاکسي	Anafilassi
د اسلام انبیاء	Profeti dell'islam
لاسپېله	Guanto
محمد زکريا رازي	Rhazes
مېترونيدازول	Metronidazolo
گرافېن	Grafene
رنځېږن	Microrganismo patogeno
ليکپاکټ	Busta
کانفدراسيون	Confederazione di Stati
ټي اېن ټي	Trinitrotoluene
چېکيان	Cechi
بغلان ولايت	Baghlan
ابټ آباد	Abbottabad
بدن	Corpo (anatomia)
يزد ولايت	Regione di Yazd
قم	Qom
توماس اېډورډ لارېنس	Thomas Edward Lawrence
بيولوژيکي وسلې	Arma biologica
ټېغکه	Laniidae
عباس ۱	'Abbas I il Grande
باميان ولايت	Provincia di Bamiyan
ای اچ ۶۴ آباچی	Boeing AH-64 Apache
لمرگلی	Helianthus annuus
د سهېلي خراسان ولايت	Khorasan meridionale
پېښه	Incidente
کرمان	Kerman (città)
احمديت	Ahmadiyya
د اگرې کلا	Forte rosso di Agra
د مذهب خپلواكي	Libertà religiosa
تيتر	Numididae
ځانگړواله	Individualismo
بادغيس ولايت	Badghis
قبة الصخرة جومات	Cupola della Roccia
اشرف غني احمدزی	Ashraf Ghani
رېبز	Scopa (strumento)
ټوپولف ټو-۱۵۴	Tupolev Tu-154
نړیواله پېغله	Miss Mondo
آټوکراسي	Autocrazia
خواړه ساتنه	Conservazione degli alimenti
مارگريت ميتچېل	Margaret Mitchell
آرگېنين	Arginina
سوخوی سو ٢٧	Sukhoi Su-27
ام۱ آبرامس	M1 Abrams
غزني	Ghazni
وختتېری	Intrattenimento
کندهار ولايت	Provincia di Qandahar
کاپيسا ولايت	Kapisa
هلمند ولايت	Helmand
فارياب ولايت	Faryab
محراب	Mihrab
د الازهر پوهنتون	Università al-Azhar
بوتل پزی څوڅ	Tursiops truncatus
اوسېلوسکوپ	Oscilloscopio
توحيد	Tawhid
بي-٥٢ سټراټوفورټرېس	Boeing B-52 Stratofortress
کوډيين	Codeina
قبله	Qibla
فتح علي شاه قاجار	Fath Ali Shah
بېديانۍ پيشو	Felis margarita
تانبه:تاریخ	Portale:Storia
واتسلاف ۱	Venceslao I di Boemia
د اسلام پنځه بنسټونه	Cinque pilastri dell'Islam
زوی	Figlio
سکاره	Carbone vegetale
شنقار	Falco rusticolus
د ژونکې تيوري	Teoria cellulare
فولېرېن	Fullereni
نېکروسېز	Necrosi
د واشنگټن څلی	Monumento a Washington
آنتونوف-۲۲۵	Antonov An-225 Mriya
وييپوهنه	Lessicologia
ننگرهار ولايت	Nangarhar
درونکښ	Gru (tecnologia)
روژه	Sawm
کاني اوبه	Acqua minerale
نولۍ	Mustela putorius furo
لگښت ساتنې تگلاره	Protezionismo
آنتیستنس	Antistene
مرکزي حکومت	Stato unitario
اسماني کتابونه او صحيفې	Testi sacri
ژبساپوهنه	Psicolinguistica
اوبزمکپوهنه	Idrogeologia
اپیکوریزم	Epicureismo
اورمازده	Ahura Mazdā
درملنه	Terapia
يعقوب کندي	Al-Kindi
گورجېس	Gorgia
سياسي فلسفه	Filosofia politica
جوهر دوداییف	Džokhar Dudaev
ايوب	Giobbe
د افغانستان ولسي لاره	Sououd-e-Melli
ستورمزلي	Esplorazione spaziale
اېکونومېسټ	The Economist
تورگوت اوزال	Turgut Özal
نورتورپ گرومان بي ۲ سپېريټ	Northrop-Grumman B-2 Spirit
لمريز لېږديز کليز	Calendario persiano
فراه ولايت	Provincia di Farah
غزني ولايت	Provincia di Ghazni
وړانگدرملنه	Radioterapia
کوټه	Stanza (architettura)
شاپ	Supposta
پوهنځی	Facoltà universitaria
نکوټي يانا ټیبېکم	Nicotiana tabacum
بلوچستان	Belucistan (regione geografica)
سيد حسن نصرالله	Hassan Nasrallah
دايکندي ولايت	Daikondi
پنجشېر ولايت	Panjshir
زړه نابری	Insufficienza cardiaca
ټوپولف ټو-۹۵	Tupolev Tu-95
بلخ	Balkh (sito archeologico)
امونيم نايټرېټ	Nitrato d'ammonio
آسيايي زمري	Panthera leo persica
کامبوجيه ۲	Cambise II di Persia
سرپل ولايت	Provincia di Sar-e Pol
پکتيا ولايت	Paktia
خوارزم	Corasmia
بهرونه	Esportazione
ايټا جېمز	Etta James
كنسرټ	Concerto (evento musicale)
هرات ولايت	Provincia di Herat
سمنگان ولايت	Samangan
نيمروز ولايت	Nimruz
روزگان ولايت	Oruzgan
جوزجان ولايت	Jowzjan
ميدان وردگ ولايت	Vardak
کورکوړۍ	Meropidae
شننيزه فلسفه	Filosofia analitica
سېموېل کولټ	Samuel Colt
جلالکوټ	Jalalabad (Afghanistan)
خيبر پښتونخوا	Khyber Pakhtunkhwa
سينوسايټس	Sinusite
موکشا	Mokṣa
اسماعيل	Ismaele
نسخوږی	Dolore addominale
زينت امان	Zeenat Aman
لسڅنډی	Decagono
چينايي فلسفه	Filosofia cinese
بوينگ بي ۲۹	Boeing B-29 Superfortress
کرينه کپور	Kareena Kapoor
بوينگ بي ۱۷ فلاينگ فورټرېس	Boeing B-17 Flying Fortress
اسيډوسېز	Acidosi
اوبي ژرنده	Mulino ad acqua
فلېپيني عقاب	Pithecophaga jefferyi
لغمان ولايت	Laghman
پيېرې لويېس ناپولېيون کيوانارې	Pierre-Louis Cavagnari
مولتان	Multan
کوټه (ښار)	Quetta
پکتيکا ولايت	Paktika
خوست ولايت	Provincia di Khowst
کيفيت	Qualità
د لوی اختر مياشت	Dhu l-Hijja
بريدمن	Tenente
علي اکبر هاشمي رفسنجاني	Ali Akbar Hashemi Rafsanjani
ايمن الظواهري	Ayman al-Zawahiri
رنځورپاله	Infermiere
غور ولايت	Ghowr
تخار ولايت	Takhar
کندوز ولايت	Provincia di Konduz
د پاکستان د خلکو گوند	Partito Popolare Pakistano
د اتریش د خلک ګوند	Partito Popolare Austriaco
ايبوپروفېن	Ibuprofene
کارسک گيدړ	Vulpes corsac
ابهيشېک بچچن	Abhishek Bachchan
سالنډي	Dispnea
کونړ ولايت	Konar
پروان ولايت	Parvan
آيت	Ayat
قول اردو	Corpo d'armata
ايمفيسېما	Enfisema
احمد ياسين	Ahmed Yassin
برهان الدين رباني	Burhanuddin Rabbani
پريټي زېنتا	Preity Zinta
صحابه	Sahaba
سمایلوډون	Smilodon
مېرمن	Moglie
اوڅنډی	Ettagono
د افغانستان پېښليک	Storia dell'Afghanistan
کابل ولايت	Provincia di Kabul
ټېډ	TED (conferenza)
آندری کاراطايف	Andrej Korotaev
سلطان محمود غزنوي	Mahmud di Ghazna
د زړه ارېتميا	Aritmia
پینټریټ	Tetranitrato di pentaeritrite
اسلامي هنر	Arte islamica
اسلامپالنه	Islamismo
پوښتنه	Quesito
هیکسوجن	Ciclotrimetilentrinitroammina
ميناتو	Minato
وزيرستان	Waziristan
اوښلن لوگی	Gas lacrimogeno
کوستا کونکورديا	Costa Concordia
د زړه ناروغۍ	Cardiopatia
ابو حنيفه (امام اعظم)	Abu Hanifa al-Nu'man
مرکاوا شوبله	Merkava
جوهر	Essenza (filosofia)
ټوپولف ټو-۱۶۰	Tupolev Tu-160
شيطاني آيات	I versi satanici
خيبر دره	Passo Khyber
شاپور ۱	Sapore I
سيلدينافيل	Sildenafil
تکبیر	Takbīr
مالي کال	Anno fiscale
سوخوی سو-۲۵	Sukhoi Su-25
پرولاکټين	Prolattina
ټانگتوره	Datura
تیسفون	Ctesifonte
ډېلي ټيليگراف	The Daily Telegraph
سټرېپټومايسين	Streptomicina
هندي څمڅه منگور	Naja naja
ټې-۹۰	T-90
نادر شاه افشار	Nadir Shah
د بوټي هورمون	Fitormone
اسلامي فلسفه	Filosofia islamica
سبسيډي	Sussidio
د پراگ کلا	Castello di Praga
آنتونوف-۱۲۴	Antonov An-124 Ruslan
هود	Hud (profeta)
خړانکه	Anthus
ملا محمد عمر	Mohammed Omar
فريد الدين عطار	Farid al-Din 'Attar
د خدای پاک مياشت	Rajab
کړنی سېک	Potenziale d'azione
امام احمد بن حنبل	Ahmad ibn Hanbal
سوخوی پک فا	Sukhoi PAK FA
ابو الکلام آزاد	Abul Kalam Azad
شاهرخ افشار	Shahrokh di Persia
ام کيو-۱ پرېډاټور	General Atomics RQ-1 Predator
کوږوږ	Zigzag
زيډووډين	AZT
بديع الزمان سعيد نورسي	Said Nursi
گلروزنه	Floricoltura
افغانۍ	Afghani afghano
مېگ ۲۵	Mikoyan-Gurevich MiG-25
د سږو اوندنه خنډيزه ناروغي	Broncopneumopatia cronica ostruttiva
احمد شاه مسعود	Ahmad Shah Massoud
داسو میراژ- ۲۰۰۰	Dassault Mirage 2000
نهڅنډی	Ennagono
آزاد کشمير	Azad Kashmir
اوبسپی	Lutrinae
چينايي دوديزه درملگري	Medicina tradizionale cinese
گېلگېت بالتستان	Gilgit-Baltistan
بلوڅان	Baluchi
ټراک	Sylvia borin
کېټ وېنسلېټ	Kate Winslet
نيوموتوراکس	Pneumotorace
اورو لانکاسټر	Avro 683 Lancaster
لرغونې فلسفه	Filosofia antica
زين العابدين بن علي	Zine El-Abidine Ben Ali
يوني ماشين	Propulsore ionico
نېټه	Formato della data
ایزو ۹۰۰۰	Norme della serie ISO 9000
اليسع	Eliseo (profeta)
معمولي څوڅ	Delphinus delphis
ترچ مير	Tirich Mir
مطبوعاتي اعلاميه	Comunicato stampa
محمد نجيب الله	Mohammad Najibullah
قونسلگري	Agente consolare
زنځيري غوڅندۍ	Motosega
فدرالي قبايلي سيمې	Aree Tribali di Amministrazione Federale
گونگه ښارو	Bombycilla
د مذهب فلسفه	Filosofia della religione
ډايازيپم	Diazepam
سوخوی سو-۲۴	Sukhoi Su-24
کورټيکوسټېرويډ	Corticosteroide
غوږور ښاپېرک	Plecotus auritus
چندړ	Santalum album
سيد قطب	Sayyid Qutb
بوکو حرام	Boko Haram
السلام عليکم	Salām
خسرو پرويز	Cosroe II
اېنډوسکوپي	Endoscopia
مېړه	Marito
طبله	Tabla
غونډل	Theraphosidae
گندهارا	Regno di Gandhāra
کوډېکس	Codice (filologia)
يان ژيژکا	Jan Žižka
يوم	Vanga
ستره لوبه	Grande gioco
لاجورد	Lapislazzuli
مقتدی الصدر	Muqtada al-Sadr
چت	Pavimento
يزيد بن معاويه	Yazid ibn Mu'awiya
آلانين	Alanina
احمد ضيا مسعود	Ahmad Diyāʾ Masʿud
ښکلي هنرونه	Belle arti
افدرين	Efedrina
ای اچ ۱ کبرا	Bell AH-1 Cobra
سورة الفاتحة	Al-Fātiḥa
سورة البقرة	Al-Baqara
سورة آل عمران	Sura III
جنگسالار	Signore della guerra
د سږو امبولي	Embolia polmonare
ښي لاسی او کيڼ لاسی ترافيک	Mano da tenere
برات	Sha'ban
De Havilland Mosquito	De Havilland DH.98 Mosquito
کجکي ولسوالۍ	Distretto di Kajaki
کيشپ	Testudines
شکودا اوکټاويا	Škoda Octavia
سټېنگر FIM-92	FIM-92 Stinger
دماغي مړينه	Morte cerebrale
مخ (چاپي رسنۍ)	Page
د وټيزو همکاريو سازمان	Organizzazione di cooperazione economica
هېوادپال	Patriot
شوننېزم	Sciovinismo
امريکا غږ	Voice of America
درې بعدي چاپگر	Stampa 3D
مامولکه	Motacilla
حسن البنا	Hasan al-Banna
سورة الحجرات	Sura XLIX
ډېل کارنېگي	Dale Carnegie
روح الله نېکپا	Rohullah Nikpai
سورة المجادلة	Sura della Disputa
مېتی	Piccone
مادهوري ډکشټ	Madhuri Dixit
د ماغزو تومور	Tumore cerebrale
د افغان-انگرېز دويمه جگړه	Seconda guerra anglo-afghana
سورة الزلزلة	Al-Zalzala
سار	Buteo rufinus
اکشې کمار	Akshay Kumar
سورة الفيل	Al-Fil
مکه معظمه	Provincia della Mecca
سورة الإخلاص	Al-Ikhlāṣ
سپين توت	Morinda citrifolia
سورت	Sura
د هند کمونیست گوند (مارکسیست)	Partito Comunista d'India (marxista)
حديث	Hadíth
شاپور ۲	Sapore II
حج	Hajj
ټې-۸۰	T-80
ان هيداوې	Anne Hathaway (Shakespeare)
امام بخاري	Bukhari
ميل مي - ۲۸	Mil Mi-28
ديکلوفيناک	Diclofenac
سوخوی سو ۳۵	Sukhoi Su-35
پيچکاري	Iniezione (medicina)
سنگين ولسوالۍ	Distretto di Sangin
اواران ولسوالۍ	Distretto di Awaran
بارخان ولسوالۍ	Distretto di Barkhan
ابن طفيل	Ibn Tufayl
ملالۍ جويا	Malalai Joya
فيفا	Fédération Internationale de Football Association
سوشميتا سېن	Sushmita Sen
ليلا علي	Laila Ali
هېنري مورټېمر ډيورنډ	Mortimer Durand
رابعه بصري	Rābiʿa al-ʿAdawiyya
بېنزيل پېنيسيلين	Benzilpenicillina
ريشي کپور	Rishi Kapoor
۳۹×۷،۶۲ مرمی	7,62 × 39 mm
پسابند ولسوالۍ	Distretto di Pasaband
ماريه قبطيه	Marya al-Qibtiyya
حفصه بنت عمر بن خطاب	Hafsa bint Umar
اميشا پټېل	Amisha Patel
صفيه بنت حيي بن اخطب	Safiyya bint Huyayy
حاد مايلوييد ليوکېمي	Leucemia mieloide acuta
حاد کرونري ساينډروم	Sindrome coronarica acuta
د کارلشتین کلا	Castello di Karlštejn
اروپايي اوښاره	Mantis religiosa
پلسيوسور	Plesiosauria
کاموف کا ٥٠	Kamov Ka-50
گڼ پوهيال	Uomo universale
شري دېوي	Sridevi
د سپاه پاسداران انقلاب اسلامی ځواک	Corpo delle Guardie della rivoluzione islamica
آنتونوف-۱۲	Antonov An-12
نوشاخ	Noshaq
خبري غونډه	Conferenza stampa
ايليوشين-۹۶	Ilyushin Il-96
خټگري	Muratura
بسم الله الرحمن الرحيم	Basmala
دويمه خور	Rabi' II
کلورامفينيکول	Cloramfenicolo
انټر سرويس انټېلېجنس (ISI)	Inter-Services Intelligence
کيچ ولسوالۍ	Distretto di Kech
چاغي ولسوالۍ	Distretto di Chagai
اېسټروجن	Estrogeno
HACCP	Analisi dei rischi e controllo dei punti critici
غزل	Ghazal
شهاب الدين سهروردي	Sohravardi
مېگانېورا	Meganeura monyi
د پاکستان د انصاف غورځنگ	Pakistan Tehreek-e-Insaf
عبدالله بن عمر البيضاوي	Al-Baydawi
اېرېسوس موراویکوس	Eresus moravicus
د ډيورنډ کرښه	Linea Durand
چنگو	Vanellinae
يعقوب	Giacobbe
لارا دتا	Lara Dutta
الجاحظ	Al-Jāḥiẓ
امام شافعي	Muhammad ibn Idris al-Shafi'i
سيد جمال الدين افغاني	Jamal al-Din al-Afghani
خرېزانتېما توغندی	Hrizantema
نصرت فتح علي خان	Nusrat Fateh Ali Khan
نور محمد ترکی	Nur Mohammad Taraki
سادات	Sayyid
د راديوايزوټوپونو ترموبريښنایی جنريټر	Generatore termoelettrico a radioisotopi
آلانين ټرانس امينېز	Alanina transaminasi
ختيځي مچۍ	Apis cerana
ختيځه فلسفه	Filosofie orientali
اروپایی زرغون څرموښکۍ	Lacerta viridis
عبدالقادر گيلاني	Abd al-Qadir al-Gilani
عبدالله عزام	Abd Allah al-Azzam
عبدالکريم سروش	Abdolkarim Soroush
ميمنه ولسوالۍ	Meymaneh
الشباب	Al-Shabaab
سردار محمد داود خان	Mohammed Daud Khan
عبدالقدير خان	Abdul Qadeer Khan
سلطان قطب الدين ايبک	Qutb al-Din di Delhi
پلازموډيم وايوېکس	Plasmodium vivax
بيټالکټمېز	Beta-lattamasi
پلازموډيم فالسيپارم	Plasmodium falciparum
امام مالک بن انس	Malik ibn Anas
نورالدين عبدالرحمن جامي هروي	Giami
عمران خان (لوبگر)	Imran Khan (attore)
رودکي	Rudaki
خان عبدالغفار خان	Abdul Ghaffar Khan
غزی	Himantopus
عبدالرحيم وردگ	Abdul Rahim Wardak
عبدالله عبدالله	Abdullah Abdullah
جرمېن جېکسن	Jermaine Jackson
ابن حزم اندلسي	Ibn Hazm
والېري ولاديميروويچ پولياکوف	Valerij Vladimirovič Poljakov
گلبدين حکمتيار	Gulbuddin Hekmatyar
احمد شاه قاجار	Ahmad Qajar
ژولرغونپوهنه	Archeozoologia
مېلبورن پوهنتون	Università di Melbourne
داسو میراژ اف‌۱	Dassault Mirage F1
دېو انند	Dev Anand
آر پي جي-۷	RPG-7
آغا محمد خان قاجار	Muḥammad Khān Qājār
صالح	Salih
گڼونکی	Ragioneria
د ۲ کا ۱۲ کوب راکټی سیستم	Kub (missile)
کنکه لېږندويه انسېفلايټس	Encefalite trasmessa da zecche
د افغانستان جگړه (۲۰۰۱)	Operazione Enduring Freedom
اس-۲۰۰	S-200
قانوني لاسوندونه	Negozio giuridico
ويي جوړښت	Formazione delle parole
تايروکسين	Triiodotironina
ادريس	Idris (islam)
د سولې نړيواله ورځ	Giornata internazionale della pace
روماتولوجي	Reumatologia
ناصر خسرو	Naser-e Khosrow
پادشاهی جومات	Moschea Badshahi
ذوالکفل	Dhu l-Kifl
رنجيت سېنگ	Ranjit Singh
شمي کپور	Shammi Kapoor
بيت الله محسود	Baitullah Mehsud
ابوبکر	Abū Bakr
ابو مسلم خراساني	Abu Muslim
جيورج ايډېن	George Eden, I conte di Auckland
سلطان علاوالدين غلجی	Ala-ud-din II di Delhi
کاشي	Vetrina (ceramica)
تفسير	Tafsir
گوگل	Mediastino
راجپوت	Rajput
آیت الله سيستاني	Ali al-Sistani
صليبي غڼه	Araneus diadematus
چورليځ	Axis
محمد علي شاه قاجار	Mohammad Ali Qajar
فرانسېس يسېدرو اېجورت	Francis Ysidro Edgeworth
محمد نادر شاه	Mohammed Nadir Shah
آنتونوف-۱۴۰	Antonov An-140
سلمان ابن عبدالعزیز آل سعود	Salman dell'Arabia Saudita
پټه لرونکی ژگاگ	Mephitis mephitis
سليووويټز	Slivovitz
ابو الاعلى مودودي	Abu l-A'la Maududi
اردشیر پاپاکان	Ardashir I
هېماټويوريا	Ematuria
د سوریانو ټولواکمني	Dinastia Suri
جده	Gedda (Arabia Saudita)
د چين نړيواله راډيو	Radio Cina Internazionale
الېکسانډر برنېس	Alexander Burnes
هندي فلسفه	Filosofia indiana
دليپ کمار	Dilip Kumar
سونيل دت	Sunil Dutt
د ايران هوايي ځواک	Niru-ye Havayi-ye Artesh-e Jomhuri-ye Eslami-e Iran
دهرمندر	Dharmendra
ملا دادالله اخوند	Dadullah Akhund
شاه محمود خان	Shah Mahmud Khan
لوييس سلوتين	Louis Slotin
شاهد اپریدی	Shahid Afridi
ال-۱۵۹ الکا	Aero L-159 ALCA
ابراهيم لودي	Ibrahim Lodi
ولاديمير الېکساندروويچ کريوچکوف	Vladimir Aleksandrovič Krjučkov
لمن لگښت	Costo marginale
افغان ملي پوځ	Esercito nazionale dell'Afghanistan
د افغانستان د فوټبال فدراسيون	Federazione calcistica dell'Afghanistan
کارلوی واری	Karlovy Vary
خاد	KHAD
اهل بيت	Ahl al-Bayt
خوست	Khowst
چخانسور ولسوالۍ	Distretto di Chakhansur
سوات ولسوالۍ	Distretto di Swat
د هخامنشیانو ټولواکمني	Impero achemenide
شکودا ۹ ټې اړ	Škoda 9Tr
شکودا سوپرب	Škoda Superb
معیاري ژبه	Lingua standard
سايکلوفوسفمايډ	Ciclofosfamide
ایندومټاسین	Indometacina
سورلان	Wolfhound
اېنالاپريل	Enalapril
سپيرونولکټون	Spironolattone
مېبېندازول	Mebendazolo
هېموسېدرين	Emosiderina
اوکټوجن	Ciclotetrametilentetranitroammina
اوميپرازول	Omeprazolo
بودېسونايد	Budesonide
فېنواکسيمېتيل پېنيسيلين	Fenossimetilpenicillina
کلوکساسيلين	Cloxacillina
ديجوکسين	Digossina
ډاپسون	Dapsone
ډيلټيازيم	Diltiazem
مېټوټرکسات	Metotrexato
دوكسيسايكلين	Doxiciclina
جنټامايسين	Gentamicina
لوپيناوير	Lopinavir
امټريسيټابين	Emtricitabina
ډيډانوسين	Didanosina
ريټوناوير	Ritonavir
لاميووډين	Lamivudina
ساکويناوير	Saquinavir
رانيتيدين	Ranitidina
نېلفيناوير	Nelfinavir
وانکومايسين	Vancomicina
سالمېټېرول	Salmeterolo
یوریا نايټريټ	Nitrourea
الاقصی جومات	Moschea al-Aqsa
د افغانستان اسلامي امارت	Emirato islamico dell'Afghanistan
مسجد الحرام	Al-Masjid al-Haram
منبر	Minbar
ولادېمير افاناسېويچ لياخوف	Vladimir Afanas'evič Ljachov
اماسټيگوټ	Amastigote
سوخوی سو ٣٧	Sukhoi Su-37
حبيبه سهرابي	Habiba Sarabi
کرېشما کپور	Karisma Kapoor
رېکها	Rekha
شرميلا تاگور	Sharmila Tagore
اناهيتا راتبزاد	Anahita Ratebzad
حميرا بېگم	Humaira Begum
ريحانه بنت زيد قرظي	Rayhana bint Zayd
مينا کماري	Meena Kumari
وحيده رحمان	Waheeda Rehman
شبانه اعظمي	Shabana Azmi
حميده برمکي	Hamida Barmaki
مينا کشور کمال	Meena Keshwar Kamal
ديا مرزا	Diya Mirza
آلماني چابکۍ	Blattella germanica
غياث الدين کيخسرو بن کيقباد	Kaykhusraw II
هنري کوربان	Henry Corbin
مظفر الدين شاه قاجار	Mozaffar al-Din Shah Qajar
د درانيانو ټولواکمني	Impero Durrani
گردېز	Gardez
ملټيپل ميولوما	Mieloma multiplo
بوينگ بي ۴۷ سټراټوجېټ	Boeing B-47 Stratojet
اسکاريس لومبريکويډېس	Ascaris lumbricoides
سونو نېگم	Sonu Nigam
ابن زهر	Ibn Zuhr
ويليم مونټگمري وات	William Montgomery Watt
حبيب الله کلکاني	Habibullah Kalakānī
لومړۍ خور	Rabi' I
لښکرگاه	Lashkar Gah
تالقان	Taloqan
نادعلي ولسوالۍ	Distretto di Nad Ali
دوشکا (د الوتکو ويشتونکي ماشيندار)	DShK
بيشاپور	Bishapur
شريعت	Shari'a
اوزبکان	Uzbeki
ازمېښتون	Laboratorio
جيروسكوپ	Giroscopio
تاجکيان	Tagiki
سني اسلام	Sunnismo
آزربايجاني منات	Manat azero
بې پيلوټه الوتکه	Aeromobile a pilotaggio remoto
محمد اقبال	Muhammad Iqbal
فقه	Fiqh
چنگېز ايتمانوف	Čyngyz Ajtmatov
مۍ	Vigna radiata
د باميانو بودايي پژۍ	Buddha di Bamiyan
تورکمنان	Turkmeni
نړیوال سازمان	Organizzazione internazionale
د ژبې فلسفه	Filosofia del linguaggio
شانگهای د همکاريو سازمان	Organizzazione di Shanghai per la cooperazione
کلبيان	Cinismo
د آزادۍ راډيو	Radio Free Europe
اورنگزیب عالمگیر	Aurangzeb
راني موکېرجي	Rani Mukherjee
مسجد نبوي	Moschea del Profeta
اسلاموفوبيا	Islamofobia
ازبکستاني سوم	Som uzbeko
صفره	Safar
ابن تيميه	Ibn Taymiyya
ماتريديه	Maturidismo
بولندوی	Tenente colonnello
د افغانستان ولسوالۍ	Distretti dell'Afghanistan
مېټامتريال	Metamateriale
الوتکه (فلم)	L'aereo più pazzo del mondo
توبه	Ravvedimento
ختيځي کيکه	Xenopsylla cheopis
د شاه فیصل جومات	Moschea Faysal
د اوبو ښاپېرک	Myotis daubentonii
نېفروټېک ساينډروم	Sindrome nefrosica
ادريس شاه	Idries Shah
د افغانستان د لارښودانو لړليک	Sovrani dell'Afghanistan
کوهسان ولسوالۍ	Distretto di Kohsan
هډه	Hadda
سنتره	Citrus × tangerina
نخاعي شريان	Arteria vertebrale
تومانچه مادل ۵۲	CZ 52
هريپور (پاکستان)	Haripur (Pakistan)
د الماني ژبې گرامر	Grammatica tedesca
ISO 22000	ISO 22000
صلی الله عليه وسلم	Pbsl
اشاعره	Ashariti
ټريپانوسوما	Trypanosoma
عبدالرب رسول سياف	Abd al-Rasul Sayyaf
د ميوند جگړه	Battaglia di Maiwand
ماشین گڼ ماډل ۵۹	Vz-59
څاڅکي	Collirio
خواجه عبدالله انصاري	Abd Allah Ansari di Herat
سمېع يوسف	Sami Yusuf
محمد شاه قاجار	Muhammad Shah Qajar
مقبول فدا حسین	Maqbool Fida Husain
محمد عالم خان	Mohammed Alim Khan
پروټينيوريا	Proteinuria
بوللـه	Qasida
پښتو ابېڅي	Alfabeto Pashto
رضوي خراسان ولايت	Razavi Khorasan
بفر سټېټ	Stato cuscinetto
کونډه	Moschettone
تومانچه مادل ٧٥	CZ 75
جعفر اباد ولسوالۍ	Distretto di Jafarabad
ټرانس امينېشن	Transamminazione
گلومېرولونېفرايټس	Glomerulonefrite
بوکان	Bukan
آنتونوف-۱۴۸	Antonov An-148
کلات ولسوالۍ (بلوچستان)	Distretto di Kalat
ابهيدا	Abhidhamma Piṭaka
پرتلیزه ژبپوهنه	Analisi contrastiva
ټوپولف ټو-۳۳۴	Tupolev Tu-334
ډئيزم	Deismo
دگماتېزم	Dogma
گلسر	Serinus pusillus
اوبدرملنه	Idroterapia
ښځه په اسلام کې	Storia della donna nell'Islam
ملي گټې	Ragion di Stato
جان گرين	John Green (scrittore)
د تودوخې د لېږد وړتیا	Coefficiente di scambio termico
سامويل الېکسانډر کينير وېلسن	Samuel Alexander Kinnier Wilson
اسلامي تاريخ	Storia dei popoli islamici
امام جومات	Moschea dello Scià
کتيتر	Catetere
آريانا افغان هوايي شرکت	Ariana Afghan Airlines
د چېک د جمهوریت هوایي ځواک	Vzdušné síly armády České republiky
معتزله	Mutazilismo
شهاب ۳	Shahab-3
اسحاق	Isacco
د کوچني اختر مياشت	Shawwal
زو – ۲۳ – ۲	23 mm ZU-23
اېف ۱ لاسي بم	Granata F1 (Unione Sovietica)
ټاټرا ۸۱۳	Tatra T813
د افغانستان ملي لرغونتون	Museo di Kabul
عينک د تامبې کان	Mes Aynak
خلخال ولسوالۍ	Provincia di Khalkhal
درملپېژندنه	Farmacodinamica
ريگويدا	Ṛgveda Saṃhitā
تارو	Pernice
حسن الهضيبي	Hasan al-Hudaybi
طيبه لښکر	Lashkar-e Taiba
نورستانيان	Nuristani
لاله سری	Falco chicquera
جي اېف ۱۷ تهنډر	Joint Fighter JF-17 Thunder
حامد کرزی نړيوال هوايي ډگر	Aeroporto Internazionale di Kabul
وزلوبه	Buzkashi
تپندۍ	Cazzuola
معمولي وامبټ	Vombatus ursinus
تور-ام۱	Tor (missile)
بوټځمکپوهنه	Fitogeografia
لېیوروس قوینقوېستریاتوس	Leiurus quinquestriatus
ملتون	Azienda
اسلامي ساينس	Scienza e tecnica islamiche
باغران ولسوالۍ	Distretto di Baghran
گرمسېر ولسوالۍ	Distretto di Garmsir
ظهير الدين محمد بابر	Babur
ډيلوکسنايډ فورواېټ	Diloxanide furoato
ږيره ور خوگ	Sus barbatus
درېيځ (مېچپوهنه)	Cubo
آتريال فېبرېلېشن	Fibrillazione atriale
هډپوهنه	Osteologia
نيوروبورېليوسېز	Neuroborreliosi
څلورمه خور	Jumada II
ماشيندار مادل ٦١	Vz 61 Skorpion
جنت	Janna
فيزيکي کتنه	Esame obiettivo
يهودي فلسفه	Filosofia ebraica
اومان	Ephedra
امام علي آرام ځاي	Moschea dell'Imam 'Ali
ټاټرا ټې – ۳	Tatra T3
مندر	Mandir
لويه جرگه	Loya jirga
اسلامي زده کړې	Islamistica
رقم جوړؤنکي وسایل	Digitalizzazione
2G	2G
آئیسو 639-3	ISO 639-3
د زړه عضلاتي اعتلال	Cardiomiopatia
نيوروفېبروماټوسېز	Neurofibromatosi
درېيمه خور	Jumada I
ټوپک مادل ٥٨	Vz. 58
پېرودونکی	Clientela (economia)
عيسوي فلسفه	Filosofia cristiana
د سږو بوغمه	Edema polmonare acuto
آی خانم	Ai-Khanum
وییزېرمه	Glossario
معاصره فلسفه	Filosofia moderna
يوناني درمل	Erboristeria
ليکتوکي	Cancelleria (ufficio)
د اکولا اوبتل	Classe Akula I/II
ډانا مادل ۷۷ لیري ویشتونکي توپ	ShKH-77
د رېږدلې انجنيري	Ingegneria sismica
ماليکولي ننوونی	Setacci molecolari
برېښنایي مرمري سکيټ کب	Torpedo marmorata
هېماټوپويسز	Emopoiesi
هندو (ورځپاڼه)	The Hindu
گجرات	Gujrat
سجده	Sujud
ميدان ښار ولسوالۍ	Maidanshahr
جهنگ ولسوالۍ	Distretto di Jhang
د سيستان او بلوچستان ولايت	Sistan e Baluchistan
ټټر	Torace degli insetti
سني ډيول	Sunny Deol
د افغانستان اسلامي حزب	Hezb-i Islami
د علیت برهان	Argomento cosmologico
بژېونوف صومعه	Abbazia di Břevnov
ستراهوف صومعه	Monastero di Strahov
افغانايټ	Afghanite
هندو خدايان	Divinità induiste
اېلډرېډ پاټېنجر	Eldred Pottinger
سونيل شيټي	Sunil Shetty
ډانا ټايرون روهراباکر	Dana Rohrabacher
اېکزېما	Eczema
د افغان-انگرېز لومړۍ جگړه	Prima guerra anglo-afghana
مردان	Mardan
لرغونې يوناني فلسفه	Filosofia greca
يشناټکی	Punto di ebollizione
د فارس ولايت	Fars
غزاله جاوېد	Ghazala Javed
د نړۍ برحاله هېوادمشران	Capi di Stato e di governo in carica
مستونگ ولسوالۍ	Distretto di Mastung
انار دره ولسوالۍ	Distretto di Anar Dara
هالي بېري	Halle Berry
غبرگه ښیښه	Vetro camera
1G	1G
د روسيې دولتي کتابتون	Biblioteca di stato russa
ابو الفتح الشهرستاني	Al-Shahrastani
د بوټي ژونکه	Cellula vegetale
فېروز خان	Feroz Khan
د استخباراتو پرانيستى سرچينه	OSINT
اسيا پېسفيک	Asia Pacifica
د لوگر ولايت د بيارغونې ډله	Provincial Reconstruction Team
لادا اوبتل	Classe Lada
پېښور	Peshawar
واشېر ولسوالۍ	Distretto di Washer
آر پي جي – ۲۹	RPG-29
څېړنيزه خبريالي	Giornalismo investigativo
جرمنۍ غومبسه	Vespula germanica
مير اکبر خيبر	Mir Akbar Khyber
زهوب	Essudato
اوندن برونشيت	Bronchite cronica
د افغانستان د علومو اکاډمي	Accademia delle scienze dell'Afghanistan
طلا تپه	Tillia Tepe
اداينه	Pagamento
د افغانستان حکومت	Politica dell'Afghanistan
خروشتي	Kharoshthi
دوتنه	File (disambigua)
لافايټ جنگي بېړۍ	Classe La Fayette
ناپروکسين	Naprossene
ويکيپېډيا:نړيواله غږيزه ابېڅې	Aiuto:IPA
نوی اتلانتېس	La nuova Atlantide
تعبیه شوی چاودیدونکی وسیله	Ordigno esplosivo improvvisato
د افغان-انگرېز درېمه جگړه	Terza guerra anglo-afghana
رسم	Rasm
کرج ولسوالۍ	Provincia di Karaj
مشگين شهر ولسوالۍ	Provincia di Meshgin Shahr
نظرآباد ولسوالۍ	Provincia di Nazarabad
نمين ولسوالۍ	Provincia di Namin
گرمي ولسوالۍ	Provincia di Germi
ساوجبلاغ ولسوالۍ	Provincia di Savojbolagh
د پارس‌ آباد ولسوالۍ	Provincia di Parsabad
کوثر ولسوالۍ	Provincia di Kovsar
بېله سوار ولسوالۍ	Provincia di Bileh Savar
اردبيل ولسوالۍ	Provincia di Ardabil
بېړۍ ژرنده	Mulino natante
نير ولسوالۍ	Provincia di Nir
سولگریز جال	Rete di computer
د حکومت بڼې	Forma di governo
محمد هاشم ميوندوال	Mohammad Hashim Maiwandwal
افغان پيکا	Ochotona rufescens
پر اسلام نيوکه	Antislamismo
قارون	Core (Bibbia)
توره بوړه	Tora Bora
اسلامي وټه	Finanza islamica
کابل پوهنتون	Università di Kabul
د کاربن ډای اکسایډ ليزر	Laser ad anidride carbonica
د اصفهان ولايت	Regione di Esfahan
ويکيپېډيا:وييپانگه	Aiuto:Glossario
محمد يوسف	Mohammad Yusuf
وېشنيزه:د امريکا متحده ايالات	Categoria:Stati Uniti d'America
وېشنيزه:روسيه	Categoria:Russia
وېشنيزه:کاناډا	Categoria:Canada
وېشنيزه:برطانيه	Categoria:Regno Unito
وېشنيزه:چين	Categoria:Cina
وېشنيزه:هندوستان	Categoria:India
وېشنيزه:سعودي عربستان	Categoria:Arabia Saudita
وېشنيزه:ايران	Categoria:Iran
هانډلې پېج ټايپ او	Handley Page Type O
د مقدس جورج کلیسا	Basilica di San Giorgio (Praga)
وېشنيزه:افغانستان	Categoria:Afghanistan
وېشنيزه:الجېريا	Categoria:Algeria
وېشنيزه:عراق	Categoria:Iraq
وېشنيزه:نېدرلانډ/هالېنډ	Categoria:Paesi Bassi
وېشنيزه:نايجېريا	Categoria:Nigeria
وېشنيزه:پاکستان	Categoria:Pakistan
وېشنيزه:د روم امپراطوری	Categoria:Impero romano
وېشنيزه:مارغان	Categoria:Uccelli
وېشنيزه:بوټي	Categoria:Piante
وېشنيزه:ژونپوهنه	Categoria:Biologia
وېشنيزه:پېښليک	Categoria:Storia
وېشنيزه:ځمکپوهنه	Categoria:Geografia
وېشنيزه:ټولنه	Categoria:Società
وېشنيزه:مذهب	Categoria:Religione
وېشنيزه:ورزښت	Categoria:Sport
وېشنيزه:اروپايي اتحاديه	Categoria:Unione europea
وېشنيزه:ټوليزې رسنۍ	Categoria:Mass media
وېشنيزه:ژبه	Categoria:Linguaggi
وېشنيزه:ځمکه	Categoria:Terra
ټېمېلين اټومي برېښناکوټ	Centrale nucleare di Temelín
غوريان ولسوالۍ	Distretto di Ghoryan
رڼايي سپڼسيزې اړيكې	Comunicazioni in fibra ottica
د بشري حقونو نړېواله اسلامي اعلاميه	Dichiarazione islamica dei diritti dell'uomo
گوند مشر	Leader di partito
Henriette Confurius	Henriette Confurius
د پاکستان هوايي ځواک	Pakistani Fida'iyye
شهاب الدين محمد غوري	Muhammad di Ghur
چاربورجک ولسوالۍ	Distretto di Charborjak
سرپل	Sar-e Pol (città)
څېړونکی	Ricercatore
له پلوما	La paloma
پښتونستان	Pashtunistan
اورمکۍ	Falena
نړيواله ټولنه	Comunità internazionale
کاربون نانو نل	Nanotubo di carbonio
محصول	Prodotto
بکوا ولسوالۍ	Distretto di Bakwa
د افغانستان هوايي ځواک	De Afghan Hauai Quvah
د ۰۵۲ بي جنگي بېړۍ	Classe Luyang I
بابر بڼ	Bagh-e Babur
حاد برونشيت	Bronchite acuta
خبريال	Giornalista
سوده بنت زمعه	Sawda bint Zam'a
د حسن او حسين مياشت	Muharram
وېشنيزه:فلسفه	Categoria:Filosofia
وېشنيزه:عيسويت	Categoria:Cristianesimo
وېشنيزه:اسلام	Categoria:Islam
وېشنيزه:يهوديت	Categoria:Ebraismo
پارت	Impero partico
تاکتيک	Tattica
روينا ټنډون	Raveena Tandon
خمس	Khums
توپک مادل ۲۴	ZB vz. 24
شريا گوشل	Shreya Ghoshal
رهبانيت	Ordine religioso
گوادر ولسوالۍ	Distretto di Gwadar
اميرالمومنين	Amir al-Mu'minin
هنسېکا موټواني	Hansika Motwani
د افغانستان ولسي جرگه	Camera del Popolo
رمله بنت ابي سفيان	Ramla bint Abi Sufyan
کشک کهنه ولسوالۍ	Distretto di Kushki Kuhna
اسلام او عيسويت	Cristianesimo e islam
ساتنه	Protection
ډیسکوساوریسکوس	Discosauriscus
وړانگه	RAY
مولتان ولسوالۍ	Distretto di Multan
پشين ولسوالۍ	Distretto di Pishin
فيصل آباد ولسوالۍ	Distretto di Faisalabad
حافظ آباد ولسوالۍ	Distretto di Hafizabad
گوجرانواله ولسوالۍ	Distretto di Gujranwala
بهاولپور ولسوالۍ	Distretto di Bahawalpur
لوره لايي ولسوالۍ	Distretto di Loralai
بولان ولسوالۍ	Distretto di Bolan
ژوب ولسوالۍ	Distretto di Zhob
اټک ولسوالۍ	Distretto di Attock
بابېړی	Recidiva (medicina)
بکتر شکن	HJ-8
ایلیا ابو ماضي	Elia Abu Madi
زيارت ولسوالۍ	Distretto di Ziarat
نصير اباد ولسوالۍ	Distretto di Naseerabad
دېره غازي خان ولسوالۍ	Distretto di Dera Ghazi Khan
موسی خېل ولسوالۍ (بلوچستان)	Distretto di Musakhel
چکوال ولسوالۍ	Distretto di Chakwal
بهکر ولسوالۍ	Distretto di Bhakkar
لاهور ولسوالۍ	Distretto di Lahore
کوټه ولسوالۍ	Distretto di Quetta
ډېره بگټي ولسوالۍ	Distretto di Dera Bugti
سيالکوټ ولسوالۍ	Distretto di Sialkot
کوهلو ولسوالۍ	Distretto di Kohlu
پنجاب ولسوالۍ	Distretto di Panjab
کهمرد ولسوالۍ	Distretto di Kahmard
خراسان	Grande Khorasan
بالا بلوک ولسوالۍ	Distretto di Bala Buluk
بوښوتنيکا	Bochotnica
لال او سرجنگل ولسوالۍ	Distretto di Lal Wa Sarjangal
ابي بن خلف	Ubayy ibn Khalaf
ساهيوال ولسوالۍ	Distretto di Sahiwal
راجنپور ولسوالۍ	Distretto di Rajanpur
ويهاړي ولسوالۍ	Distretto di Vehari
ليه ولسوالۍ	Distretto di Layyah
نارووال ولسوالۍ	Distretto di Narowal
منډي بهاوالدين ولسوالۍ	Distretto di Mandi Bahauddin
ميانوالي ولسوالۍ	Distretto di Mianwali
تولید (سوداگري)	Prodotto (economia)
نوشکي ولسوالۍ	Distretto di Nushki
پنجگور ولسوالۍ	Distretto di Panjgur
د عراق او شام اسلامي دولت	Stato Islamico
د جوند ولسوالۍ	Distretto di Jawand
قاديس ولسوالۍ	Distretto di Qadis
مرغاب ولسوالۍ	Distretto di Murghab
غورماچ ولسوالۍ	Distretto di Ghormach
دېشو ولسوالۍ	Distretto di Dishu
نوزاد ولسوالۍ	Distretto di Naw Zad
لښکرگاه ولسوالۍ	Distretto di Lashkar Gah
سنگين	Sangin
يونس	Giona (profeta)
ورس ولسوالۍ	Distretto di Waras
يکاولنگ ولسوالۍ	Distretto di Yakawlang
شېبر ولسوالۍ	Distretto di Shibar
سبي ولسوالۍ	Distretto di Sibi
بادخورک	Gheppio
سيغان ولسوالۍ	Distretto di Sayghan
لودهران ولسوالۍ	Distretto di Lodhran
ننکانه صاحب ولسوالۍ	Distretto di Nankana Sahib
چنيوټ ولسوالۍ	Distretto di Chiniot
شېخپوره ولسوالۍ	Distretto di Sheikhupura
قصور ولسوالۍ	Distretto di Kasur
ویدانتا	Vedānta
د کيميا فلسفه	Filosofia della chimica
اسلام او يهوديت	Ebraismo e Islam
فک دي پوليس	Fuck tha Police
کشک ولسوالۍ	Distretto di Kushk
شېب کوه ولسوالۍ	Distretto di Shib Koh
گلستان ولسوالۍ	Distretto di Gulistan (Afghanistan)
پر چمن ولسوالۍ	Distretto di Purchaman
پشت رود ولسوالۍ	Distretto di Pusht Rod
لاش او جواين ولسوالۍ	Distretto di Lash Wa Juwayn
پښتانه	Pashtun
آبکمري ولسوالۍ	Distretto di Ab Kamari
باميان ولسوالۍ	Distretto di Bamiyan
تايواره ولسوالۍ	Distretto di Taywara
خوشاب ولسوالۍ	Distretto di Khushab
کارخ ولسوالۍ	Distretto di Karukh
خاش رود ولسوالۍ	Distretto di Khash Rod
کنگ ولسوالۍ	Distretto di Kang
خانېشين ولسوالۍ	Distretto di Reg
زرنج ولسوالۍ	Distretto di Zaranj
جهل مگسي ولسوالۍ	Distretto di Jhal Magsi
افغانان (آسټراليا)	Afghani d'Australia
رحيميار خان ولسوالۍ	Distretto di Rahim Yar Khan
خضدار ولسوالۍ	Distretto di Khuzdar
مولوي	Mawlawi
گرېگ مورټنسن	Greg Mortenson
ارغنجخواه ولسوالۍ	Distretto di Arghanj Khwa
ارگو ولسوالۍ	Distretto di Argo
ناوه ولسوالۍ	Distretto di Nawa
سيير بهادرزاده	Siyar Bahadurzada
زنده جان ولسوالۍ	Distretto di Zinda Jan
خاک سفېد ولسوالۍ	Distretto di Khaki Safed
مقر ولسوالۍ (بادغيس)	Distretto di Muqur
قلعه نو ولسوالۍ	Distretto di Qala-i-Naw
گزره ولسوالۍ	Distretto di Guzara
دولتيار ولسوالۍ	Distretto di Dawlat Yar
دولاينه ولسوالۍ	Distretto di Du Layna
اوبې ولسوالۍ	Distretto di Obe
ادرسکن ولسوالۍ	Distretto di Adraskan
گلران ولسوالۍ	Distretto di Gulran
موسی کلا ولسوالۍ	Distretto di Musa Qala
پښتون زرغون ولسوالۍ	Distretto di Pashtun Zarghun
فارسي ولسوالۍ	Distretto di Farsi
قلعه کاه ولسوالۍ	Distretto di Qala-i-Kah
شين ډنډ ولسوالۍ	Distretto di Shindand
شهرک ولسوالۍ	Distretto di Shahrak
جاغوري ولسوالۍ	Jaghuri
ساغر ولسوالۍ	Distretto di Saghar
تولک ولسوالۍ	Distretto di Tulak
چغچران ولسوالۍ	Distretto di Chaghcharan
سمبالښت	Direzione aziendale
ننداره	Show (disambigua)
وېشنيزه:هڅوب	Categoria:Cultura
وېشنيزه:لويې وچې	Categoria:Continenti
وېشنيزه:ځمکپېژنده	Categoria:Geologia
وېشنيزه:الوتکې	Categoria:Aeromobili
ايشوبی	Caldaia (riscaldamento)
تانبه:ځمکپوهنه	Portale:Geografia
تانبه:فلسفه	Portale:Filosofia
د کوکا کولا شرکت	The Coca-Cola Company
ميمونه بنت الحارث	Maymuna bint al-Harith
ويکيپېډيا:غونډال ته څنګه ورننوځو	Aiuto:Come registrarsi
جويريه بنت الحارث	Juwayriyya bint al-Harith
کيمياوي وسلې	Armi chimiche
کلمپ	Clamp
انجيل ولسوالۍ	Distretto di Injil
نوی بارکزی ولسوالۍ	Distretto di Nawa-i-Barak Zayi
چشت شريف ولسوالۍ	Distretto di Chishti Sharif
وېشنيزه:د افغانستان توکمونه	Categoria:Gruppi etnici in Afghanistan
اېلیپسوسېفالوس	Ellipsocephalus
خوبانۍ	Albicocca
څلوريځ	Distico
د افغانستان امريکايي پوهنتون	Università americana in Afghanistan
تانبه:هنرونه	Portale:Arte
علامه	Allamah
بهارک ولسوالۍ (بدخشان)	Distretto di Baharak
کينډۍ:دوراشې کامه	Template:Citazione
وېشنيزه:هېوادونه	Categoria:Nazioni
وېشنيزه:وټپوهنه	Categoria:Economia
ويکيپېډيا:پازوالان	Wikipedia:Amministratori
ويکيپېډيا:روباټان	Wikipedia:Bot
وېشنيزه:وخت	Categoria:Tempo
وېشنيزه:انټرنټ	Categoria:Internet
وېشنيزه:بوټپوهنه	Categoria:Botanica
وېشنيزه:اناتومي	Categoria:Anatomia
وېشنيزه:طب	Categoria:Medicina
وېشنيزه:سياست	Categoria:Politica
گڼنه	Contabilità
مصر	Egitto
اسلامي نظام	Stato islamico
وېشنيزه:فيلسوفان	Categoria:Filosofi
کينډۍ:Bot	Template:Bot
کاناډا	Canada
وېشنيزه:هنګري	Categoria:Ungheria
وېشنيزه:چېک جمهوريت	Categoria:Repubblica Ceca
وېشنيزه:سلواکيا	Categoria:Slovacchia
ويکيپېډيا:نيوليک	Aiuto:Esplorare Wikipedia
اکدي واکمنۍ	Impero di Akkad
وېشنيزه:مايکروسافټ	Categoria:Microsoft
تانبه:پوهنه	Portale:Scienza e tecnica
وېشنيزه:د اروپا هېوادونه	Categoria:Stati dell'Europa
وېشنيزه:اروپا	Categoria:Europa
کينډۍ:لاسوند	Template:Man
ويکيپېډيا:د ټولنې تانبه	Portale:Comunità
وېشنيزه:User languages	Categoria:Utenti per lingua
ويکيپېډيا:کارن-نوم	Wikipedia:Nome utente
عايشه بنت ابي بکر	Aisha
چارسده ولسوالۍ (غور)	Distretto di Charsada
سوداگري	Business
تانبه:ټکنالوجي	Portale:Ingegneria
کينډۍ:Softredirect	Template:Soft redirect
کينډۍ:ړنگول	Template:Cancella subito
ليکبڼه	Tipo di carattere
وېشنيزه:ژبې	Categoria:Lingue
ويکيپېډيا:General disclaimer	Wikipedia:Avvertenze generali
وېشنيزه:د چېک جمهوريت ښارونه	Categoria:Città della Repubblica Ceca
کينډۍ:Navbox	Template:Navbox
ويکيپېډيا:Shortcut	Template:Abbreviazioni
وېشنيزه:د ایران ښارونه	Categoria:Città dell'Iran
کينډۍ:Citation needed	Template:Citazione necessaria
تانبه:ژوندليکونه	Portale:Biografie
کينډۍ:Tnavbar	Template:Tnavbar
ايمان	Fede
کينډۍ:Clear	Template:Clear
کينډۍ:Col-end	Template:Colonne fine
کينډۍ:Anchor	Template:Anchor
کينډۍ:Babel	Template:Babel
کينډۍ:Commons	Template:Commons
کينډۍ:لړسرچينې	Template:References
کينډۍ:AFG	Template:AFG
کينډۍ:نابشپړ	Template:S
کينډۍ:User de	Template:Utente de
کينډۍ:User en-3	Template:Utente en-3
کينډۍ:User en-1	Template:Utente en-1
کينډۍ:User en-2	Template:Utente en-2
کينډۍ:User en	Template:Utente en
کينډۍ:User fa	Template:Utente fa
وېشنيزه:افغاني هڅوب	Categoria:Cultura dell'Afghanistan
کينډۍ:User ja	Template:Utente ja
کينډۍ:User ja-1	Template:Utente ja-1
وېشنيزه:امريکايي لرغونپوهان	Categoria:Archeologi statunitensi
وېشنيزه:آسيا	Categoria:Asia
کينډۍ:Esoteric	Template:Template complesso
کينډۍ:Mod	Template:Mod
وېشنيزه:درملپوهنه	Categoria:Farmacologia
وېشنيزه:ژبپوهنه	Categoria:Linguistica
کينډۍ:د انځور نښه	Template:Etichetta immagine
کينډۍ:Ambox	Template:Avviso
کينډۍ:دکارنبکس-بېخ	Template:BabelfishBottom
کينډۍ:هېواد-مالوماتبکس	Template:Stato
کينډۍ:ترسره شو	Template:Fatto
کينډۍ:Audio	Template:Link audio
ويکيپېډيا:ځان زده کړه (د ويکيپېډيا تړنې)	Aiuto:Tutorial/Link
کينډۍ:Start box	Template:S-inizio
کينډۍ:پوهنتون مالوماتبکس/لاسوند	Template:Università
کينډۍ:د فايرفاکس کارن	Utente:Wuzihong/Template:Utenti che usavano Firefox
کينډۍ:Ar	Template:Arabo
کينډۍ:Featured article	Template:Vetrina
وېشنيزه:User en	Categoria:Utenti en
وېشنيزه:User en-2	Categoria:Utenti en-2
کينډۍ:مالوماتبکس	Template:Infobox
کينډۍ:د ايران ولايتونه	Template:Regioni dell'Iran
کينډۍ:Navy	Template:Insegna navale
کينډۍ:User zh	Template:Utente zh
کينډۍ:Colorbox	Template:Box colorato
کينډۍ:User ru-4	Template:Utente ru-4
کينډۍ:Pp-template	Template:Pp-template
وېشنيزه:کرهڼه	Categoria:Agricoltura
کينډۍ:User ru	Template:Utente ru
کينډۍ:نغا	Template:IPA
وېشنيزه:سياستوال	Categoria:Politici
وېشنيزه:لمريز نظام	Categoria:Pianeti del sistema solare
وېشنيزه:امريکا	Categoria:America
کينډۍ:Infobox Officeholder	Template:Carica pubblica
کينډۍ:Border	Template:Border
کينډۍ:ويکيسازنه	Template:W
وېشنيزه:ليکوال	Categoria:Scrittori
کينډۍ:د کتاب مالوماتبکس-1	Template:Libro
وېشنيزه:څارګرې ادارې	Categoria:Servizi segreti
کينډۍ:سورت	Template:Corano
کينډۍ:Lang-la	Template:Latino
کينډۍ:Lang-el	Template:Lang-el
وېشنيزه:اخلاق	Categoria:Etica
د سره صليب نړيواله ټولنه	Comitato internazionale della Croce Rossa
وېشنيزه:چاودېدونكى مواد	Categoria:Esplosivi
وېشنيزه:سولګر	Categoria:Computer
وېشنيزه:توکي	Categoria:Attrezzi
کينډۍ:مالوماتبکس لويه وچه	Template:Regione geografica
وېشنيزه:پخوانی ژبې	Categoria:Lingue estinte
وېشنيزه:User ja-N	Categoria:Utenti ja-M
تانبه:اسلام	Portale:Islam
کينډۍ:دشريان-مالوماتبکس	Template:Infobox arteria
کينډۍ:Polytonic	Template:Greco
کينډۍ:نامبهمېدنه	Template:Disambigua
وېشنيزه:اسرائیلي جوماتونه	Categoria:Moschee d'Israele
وېشنيزه:د ایران امپراتورۍ او پاچاهۍ	Categoria:Persia
وېشنيزه:پوځي الوتکې	Categoria:Aerei militari
کينډۍ:Lang-grc	Template:Lang-grc
کينډۍ:FRA	Template:FRA
کينډۍ:د هېواد مالومات اوکراين	Template:Naz/UKR
کينډۍ:Npov	Template:P
وېشنيزه:User ja	Categoria:Utenti ja
وېشنيزه:User ur	Categoria:Utenti ur
وېشنيزه:User ko-N	Categoria:Utenti ko-M
وېشنيزه:User ru-N	Categoria:Utenti ru-M
وېشنيزه:وختتېری	Categoria:Intrattenimento
وېشنيزه:تاريخپوهان	Categoria:Storici
وېشنيزه:User de	Categoria:Utenti de
وېشنيزه:User de-N	Categoria:Utenti de-M
کينډۍ:د افغانستان ولايتونه	Template:Afghanistan
وېشنيزه:User en-3	Categoria:Utenti en-3
وېشنيزه:User en-N	Categoria:Utenti en-M
وېشنيزه:User fa	Categoria:Utenti fa
کينډۍ:N/A	Template:ND
وېشنيزه:د اسلام پيغمبران	Categoria:Profeti islamici
وېشنيزه:مېچپوهنه	Categoria:Geometria
کينډۍ:Weather box	Template:ClimaAnnuale
وېشنيزه:هنرمندان	Categoria:Artisti
وېشنيزه:User ja-1	Categoria:Utenti ja-1
وېشنيزه:ژمنۍ لوبې	Categoria:Sport invernali
وېشنيزه:User ko	Categoria:Utenti ko
وېشنيزه:د امريکا د متحده ايالاتو ايالتونه	Categoria:Stati degli Stati Uniti d'America
وېشنيزه:بانکوالی	Categoria:Sistema bancario
وېشنيزه:د ایران ولایتونه	Categoria:Province dell'Iran
وېشنيزه:User ru-1	Categoria:Utenti ru-1
وېشنيزه:مخدره مواد	Categoria:Droghe
وېشنيزه:اند	Categoria:Pensiero
وېشنيزه:لمريز غونډال	Categoria:Sistema solare
وېشنيزه:مخترعين	Categoria:Inventori
وېشنيزه:سر او غاړه	Categoria:Anatomia della testa e del collo
وېشنيزه:ژوپوهنه	Categoria:Zoologia
تانبه:دين	Portale:Religioni
وېشنيزه:هلیکوپترونه	Categoria:Elicotteri
وېشنيزه:ټولنيزې پوهنې	Categoria:Scienze sociali
وېشنيزه:د آفریقاهیوادونه	Categoria:Stati dell'Africa
وېشنيزه:د هخامنشیانو حکمرانان	Categoria:Impero achemenide
وېشنيزه:User ro-3	Categoria:Utenti ro-3
وېشنيزه:User ru	Categoria:Utenti ru
وېشنيزه:User ru-2	Categoria:Utenti ru-2
وېشنيزه:User ru-3	Categoria:Utenti ru-3
وېشنيزه:User ru-4	Categoria:Utenti ru-4
کينډۍ:Lang	Template:Lang
وېشنيزه:د ۱۹۵۷ کال زېږېدنې	Categoria:Nati nel 1957
لوگر ولايت	Lowgar
کينډۍ:د پاکستان سياسي جغرافي وېش	Template:Pakistan suddivisioni
وېشنيزه:افغانان	Categoria:Afghani
وېشنيزه:بي بي سي	Categoria:BBC
د آلمان دپاره آلترناتیف	Alternativa per la Germania
وېشنيزه:اوبتلونه	Categoria:Sottomarini
وېشنيزه:د افریقایي اتحادیه غړي هیوادونه	Categoria:Stati membri dell'Unione Africana
وېشنيزه:د پاکستان ایالتونه او سیمې	Categoria:Province del Pakistan
وېشنيزه:ليبيا	Categoria:Libia
وېشنيزه:افغاني رسنۍ	Categoria:Mass media in Afghanistan
وېشنيزه:د افغانستان وټه	Categoria:Economia dell'Afghanistan
کينډۍ:User ru-1	Template:Utente ru-1
وېشنيزه:روسي ساينسپوهان	Categoria:Scienziati russi
وېشنيزه:طالبان	Categoria:Talebani
وېشنيزه:بازارموندنه	Categoria:Marketing
وېشنيزه:د نړۍ هېوادونه	Categoria:Relazioni internazionali
وېشنيزه:غږپوهنه	Categoria:Fonologia
کينډۍ:Tnavbar-header	Template:Tnavbar-header
وېشنيزه:مالیه	Categoria:Finanza
وېشنيزه:روسی الوتکې	Categoria:Aerei militari sovietici-russi
وېشنيزه:د افغانستان ولايتونه	Categoria:Province dell'Afghanistan
وېشنيزه:د چېک خلک	Categoria:Cechi
وېشنيزه:آلمانی الوتکې	Categoria:Aerei militari tedeschi
وېشنيزه:مرکزي بانکونه	Categoria:Banche centrali
وېشنيزه:کيمياوي توکي	Categoria:Elementi chimici
وېشنيزه:امريکايي فيلسوفان	Categoria:Filosofi statunitensi
وېشنيزه:ساينسپوهان	Categoria:Scienziati
وېشنيزه:سولګر ملتونونه	Categoria:Aziende informatiche
وېشنيزه:د افغانستان پوځ	Categoria:Forze armate afghane
وېشنيزه:سهېلي کوريا	Categoria:Corea del Nord
وېشنيزه:د ليبيا خلک	Categoria:Libici
وېشنيزه:د آسيا ارزونه	Categoria:Valute asiatiche
وېشنيزه:ايراني سیاستوال	Categoria:Politici iraniani
وېشنيزه:د پاکستان سياستوال	Categoria:Politici pakistani
وېشنيزه:خبريالي	Categoria:Giornalismo
وېشنيزه:اوزبکستان	Categoria:Uzbekistan
وېشنيزه:عثماني پېر	Categoria:Impero ottomano
وېشنيزه:افغاني ليکوال	Categoria:Scrittori afghani
وېشنيزه:پاکستاني هېوادمشران	Categoria:Presidenti del Pakistan
وېشنيزه:مېوې	Categoria:Frutta
وېشنيزه:زهرلرونکي نباتونه	Categoria:Piante velenose
وېشنيزه:د اروپا سيمې	Categoria:Regioni d'Europa
وېشنيزه:د آسیا جغرافیا	Categoria:Geografia dell'Asia
وېشنيزه:جوماتونه	Categoria:Moschee
وېشنيزه:د ترکیې جوماتونه	Categoria:Moschee della Turchia
وېشنيزه:انتي بيوتيکونه	Categoria:Antibiotici
وېشنيزه:مسکنونه	Categoria:Analgesici
وېشنيزه:د افشاريانو حکمرانان	Categoria:Afsharidi
وېشنيزه:خبري اژانس	Categoria:Agenzie di stampa
وېشنيزه:بشرِی حقوق	Categoria:Diritti umani
وېشنيزه:ناټو	Categoria:NATO
وېشنيزه:پوځي وييونه	Categoria:Terminologia militare
وېشنيزه:وسلې	Categoria:Armi
وېشنيزه:د بېټا-لاکټاماز انتي بيوتيکونه	Categoria:Beta-lattamici
وېشنيزه:پاړسي ژبه	Categoria:Lingua persiana
وېشنيزه:اېډز	Categoria:HIV/AIDS
وېشنيزه:قران	Categoria:Corano
وېشنيزه:ناروغۍ	Categoria:Malattie
وېشنيزه:ترافيک ترانسپورت	Categoria:Trasporti
وېشنيزه:لوبې	Categoria:Discipline sportive
وېشنيزه:کورنۍ	Categoria:Famiglia
وېشنيزه:سندرغاړي	Categoria:Cantanti
وېشنيزه:وټپوهان	Categoria:Economisti
کينډۍ:د ژبې مالوماتبکس	Template:Lingua
وېشنيزه:ځمکپوهان	Categoria:Geografi
وېشنيزه:ولسواکي	Categoria:Democrazia
وېشنيزه:درمل	Categoria:Farmaci
وېشنيزه:ټانکونه	Categoria:Carri armati
وېشنيزه:ايراني هڅوب	Categoria:Cultura dell'Iran
وېشنيزه:د رومانیا ښارونه	Categoria:Città della Romania
وېشنيزه:کراچۍ	Categoria:Karachi
وېشنيزه:کابل	Categoria:Kabul
وېشنيزه:پښتانه	Categoria:Pashtun
وېشنيزه:چېکي واکمنان	Categoria:Re di Boemia
وېشنيزه:د باميان ولايت	Categoria:Bamiyan
وېشنيزه:د افغانستان ژبې	Categoria:Lingue dell'Afghanistan
وېشنيزه:هرات	Categoria:Herat
وېشنيزه:کندهار	Categoria:Kandahar
وېشنيزه:افغاني ګوندونه	Categoria:Partiti politici afghani
کينډۍ:د درملو لويې ډلې	Template:Maggiori gruppi di farmaci
کينډۍ:رنگ مالوماتبکس	Template:Infobox colore
وېشنيزه:د آسیا هېوادونه	Categoria:Stati dell'Asia
کينډۍ:تصوف	Template:Sufismo
وېشنيزه:د القلوید مواد	Categoria:Alcaloidi
نومونپوهنه	Terminologia
وېشنيزه:د بادغيسو ولایت ولسوالۍ	Categoria:Distretti della Provincia di Badghis
کينډۍ:وسله مالوماتبکس	Template:Infobox arma
کينډۍ:غوږ شه	Template:Multimedia
وېشنيزه:د ساسانیانو حکمرانان	Categoria:Civiltà sasanide
وېشنيزه:مسلمان فيلسوفان	Categoria:Filosofi islamici
وېشنيزه:ليکتوکي	Categoria:Cancelleria
وېشنيزه:بسونه	Categoria:Modelli di autobus
وېشنيزه:تصوف	Categoria:Sufismo
وېشنيزه:ورکړېنې	Categoria:Tasse
روژه (مياشت)	Ramadan
وېشنيزه:افغاني فلمونه	Categoria:Film afghani
وېشنيزه:امریکایی الوتکې	Categoria:Aerei militari statunitensi
وېشنيزه:ټراکټورونه	Categoria:Trattori
وېشنيزه:پاکستانی جنرالان	Categoria:Generali pakistani
وېشنيزه:پاکستاني جوماتونه	Categoria:Moschee del Pakistan
کينډۍ:Pp-dispute	Template:Protetta
وېشنيزه:قراني سورتونه	Categoria:Sure del Corano
وېشنيزه:د لويديځ سلاوي ژبې	Categoria:Lingue slave occidentali
وېشنيزه:User en-1	Categoria:Utenti en-1
وېشنيزه:اسلامپوهان	Categoria:Islamisti
ويکيپېډيا:ځان زده کړه (د بحث مخونه)	Aiuto:Tutorial/Discussione
ويکيپېډيا:ځان زده کړه (په ياد ولره)	Aiuto:Tutorial/Linee guida
کينډۍ:Userbox-level	Template:Userbox-level
دويم بريدمن	Sottotenente
د امانت گڼون	Conto di deposito
کينډۍ:User zh-min-nan-3	Template:Utente zh-min-nan-3
کينډۍ:Supranational European Bodies	Template:Organismi internazionali europei/Sandbox
ويکيپېډيا:ځان زده کړه (ثبتونه)	Aiuto:Tutorial/Registrazione
کينډۍ:د بلوچستان ولسوالۍ (پاکستان)	Template:Distretti del Belucistan
کينډۍ:د پنجاب ولسوالۍ (پاکستان)	Template:Distretti del Punjab (Pakistan)
ويکيپېډيا:Infobox templates	Wikipedia:Template sinottici
کوکۍ	Farfalla
قيامت	Giorno del giudizio (islam)
مولۍ	Raphanus sativus
کينډۍ:د-ن-و-ا	Template:Pagina principale/Immagine
ځانګړی:اوسني بدلونونه	Speciale:UltimeModifiche
Module:Coordinates	Modulo:Coord
د پېښور پر پوځي ښوونځي بريد	Strage di Peshawar
