Afrika	Africa
Jabaan	Giappone
Ameerikada koonfureed	America Meridionale
Norway	Norvegia
Ingiriiska	Inghilterra
Skotland	Scozia
Waalis	Galles
Waqooyiga Ayrland	Irlanda del Nord
Ireland	Irlanda
Hungaria	Ungheria
Isbania	Spagna
Mareykanka	Stati Uniti d'America
Beljim	Belgio
Luksemburg	Lussemburgo
Koon	Universo
Dhul	Terra
Nolosha	Vita
Biniaadan	Homo sapiens
George Washington	George Washington
Finland	Finlandia
Iswiidhan	Svezia
Denmark	Danimarca
Boland	Polonia
Lithuaniya	Lituania
Talyaaniga	Italia
Iswisarland	Svizzera
Austriya	Austria
Giriig	Grecia
Turkiga	Turchia
Bortuqaal	Portogallo
Yurub	Europa
Aasiya	Asia
Woqooyiga Ameerika	America del Nord
Antiarktis	Antartide
Wikipedia	Wikipedia
Holland	Paesi Bassi
New York	New York
Washington D.C	Washington
Baarliin	Berlino
Los Angeles	Los Angeles
Boeing	Boeing
Kumbuyuutar	Computer
Jineefa	Ginevra
Internet	Internet
Barack Obama	Barack Obama
Uruguay	Uruguay
London	Londra
Qaahiro	Il Cairo
Baariis	Parigi
Android	Android
Google	Google Inc.
Meksiko	Messico
Badweynta Atlaantik	Oceano Atlantico
Badweynta Baasifik	Oceano Pacifico
Kalifornia	California
Isniin	Lunedì
Janaayo	Gennaio
Febraayo	Febbraio
Maarso	Marzo
Farraare	Marte (astronomia)
Kiinya	Kenya
Itoobiya	Etiopia
Gaana	Ghana
Abriil	Aprile
May	Maggio
Juun	Giugno
Luuliyo	Luglio
Agoosto	Agosto
Sebteembar	Settembre
Oktoobar	Ottobre
Nofeembar	Novembre
Diseembar	Dicembre
Talaado	Martedì
Arbaco	Mercoledì
Khamiis	Giovedì
Jimco	Venerdì
Sabti	Sabato
Axad	Domenica
Libaax	Panthera leo
Faransiiska	Francia
Esberanto	Lingua esperanto
Ey	Canis lupus familiaris
Midowga boqortooyada Britan	Regno Unito
Yaanyuur	Felis silvestris catus
Shiinaha	Cina
Af-Faransiis	Lingua francese
Malaay	Pesce
Khamri	Bevanda alcolica
Barasiil	Brasile
François Hollande	François Hollande
Ruushka	Russia
Nibiri	Cetacea
Labajibaarane	Quadrato
Bad	Mare
Bada madaw	Mar Nero
Pi Sumad xisaabeed	Pi greco
Wiki	Wiki
Toronto	Toronto
Alabama	Alabama
São Paulo	San Paolo (Brasile)
São Paulo (Gobol)	San Paolo (stato)
Wikimedia	Wikimedia Foundation
Jimmy Wales	Jimmy Wales
Ingiriis	English (disambigua)
Jarmalka	Germania
Belarus	Bielorussia
Af-Jarmal	Lingua tedesca
Island	Islanda
Estoniya	Estonia
David Cameron	David Cameron
Raage	Saturno (astronomia)
Chocolate	Cioccolato
Dagaalada	Guerra
Kow	1 (numero)
Labo	2 (numero)
Sadax	3 (numero)
Afar (lambar)	4 (numero)
Shan	5 (numero)
0	0 (numero)
George W. Bush	George W. Bush
Laydi	Rettangolo
Latfiya	Lettonia
Ukrain	Ucraina
Jamhuuriyadda Tashik	Repubblica Ceca
Islofaakiya	Slovacchia
Isloveeniya	Slovenia
Moldofa	Moldavia
Romania	Romania
Bulgaria	Bulgaria
Roma	Roma
Jamhuriyada Makedonia	Repubblica di Macedonia
Albania	Albania
Griinland	Groenlandia
Kroatia	Croazia
Bosniya	Bosnia ed Erzegovina
Aserbiijaan	Azerbaigian
Andorra	Andorra
Jasiirada Qabrus	Cipro
Joorjiya	Georgia
Kasakhstan	Kazakistan
Malta	Malta
Monako	Principato di Monaco
Montenegro	Montenegro
Faatikan	Città del Vaticano
San Marino	San Marino
Boroksel	Bruxelles
Kuuba	Cuba
Belise	Belize
Barbados	Barbados
Indunisiya	Indonesia
Wolfgang Amadeus Mozart	Wolfgang Amadeus Mozart
Af-Turki	Lingua turca
Koonfur Afrika	Sudafrica
Aljeeriya	Algeria
Usbekistan	Uzbekistan
Biyo	Acqua
Alwaax	Legno
Telefishin	Televisione
Claude Monet	Claude Monet
Diego Velázquez	Diego Velázquez
Jili	Cile
El Greco	El Greco
Ciise	Gesù
Dusaa	Mercurio (astronomia)
Taariikh	Storia
Apple Inc	Apple
Waxaraxir	Venere (astronomia)
Jaceyl	Amore
Cirjeex	Giove (astronomia)
Uraano	Urano (astronomia)
Nicolas Sarkozy	Nicolas Sarkozy
Nebtuun	Nettuno (astronomia)
Xiddigis	Astronomia
Singabuur	Singapore
Saynis	Scienza
Buluuto	Plutone (astronomia)
Liechtenstein	Liechtenstein
Ciyaaraha	Sport
Adolf Hitler	Adolf Hitler
Facebook	Facebook
Julian Assange	Julian Assange
Dagaalkii koowaad	Prima guerra mondiale
Dagaalkii Labaad ee Aduunka	Seconda guerra mondiale
Goorsheegto	Orologio
Linux	Linux
Xisaab	Matematica
Af-Laatiin	Lingua latina
Baxrayn	Bahrein
Armania	Armenia
Seerbiya	Serbia
Bil	Luna
Istanbuul	Istanbul
Australia	Australia
Fiisigis	Fisica
Arjantiina	Argentina
Isgaarsiinta	Telecomunicazione
Peru	Perù
Bayoloji	Biologia
Waqooyiga Kuuriya	Corea del Nord
Kambodiya	Cambogia
Qur'aan	Corano
Diinsoor (xayawaan)	Dinosauria
Islaam	Islam
Ljubljana	Lubiana
World Wide Web	World Wide Web
Naag	Donna
Gabay	Poesia
Chernobyl	Disastro di Černobyl'
Milan	Milano
Torino	Torino
Liin dhanaan	Citrus × limon
Moos	Banana
Ubax	Fiore
Magaalo	Città
Napoleon Bonaparte	Napoleone Bonaparte
Xidig	Stella
Qorax	Sole
Cir	Cielo
Tuulo	Villaggio
Ooshiyaaniya	Oceania
Bahda Midaysay Qoraxdu	Sistema solare
Ilig	Dente
Hydrogen	Idrogeno
Hiliyaam	Elio
Cadaab	Inferno
Wikimedia Commons	Wikimedia Commons
Liithiyaam	Litio
Beriiliyaam	Berillio
Buug	Libro
Maalin	Giorno
Bariga Timor	Timor Est
Sanad	Anno
Qarni	Secolo
Oslo	Oslo
Lissabon	Lisbona
Dubay	Dubai
Lionel Messi	Lionel Messi
Booron	Boro
Versailles	Versailles
Kaarboon	Carbonio
Nitrojiin	Azoto
Ogsajiin	Ossigeno
FC Internazionale Milano	Football Club Internazionale Milano
Meere	Pianeta
Muusig	Musica
Moskow	Mosca (Russia)
Foloriin	Fluoro
Af-Taliyaani	Lingua italiana
Niyoon	Neon
Saint Petersburg	San Pietroburgo
Jad	Ciad
Sodhiyaam	Sodio
Woqooyi	Nord
Magniisiyaam	Magnesio
Alumiiniyaam	Alluminio
New Zealand	Nuova Zelanda
Koonfur	Sud
Hindiya	India
Silikoon	Silicio
Faransiyaam	Francio
Tuvalu	Tuvalu
Fosforos	Fosforo
Xadiid	Ferro
Galbeed	Ovest
Salfar	Zolfo
Bari (Jiho)	Est
Jasiiradaha Solomon	Isole Salomone
Koloriin	Cloro
Koofurta Holland	Olanda Meridionale
Balau	Palau (stato)
Aargon	Argon
Nawru	Nauru
Firefox	Mozilla Firefox
Waqooyiga Holland	Olanda Settentrionale
Botashiyaam	Potassio
Zeeland	Zelanda (Paesi Bassi)
Kaalshiyaam	Calcio (elemento chimico)
Flevoland	Flevoland
Lead	Piombo
Jasiirada Marshall	Isole Marshall
Kiribati	Kiribati
Mongolia	Mongolia
Fiji	Figi
Iskaandhiyaam	Scandio
Titaaniyaam	Titanio
Fanansuwela	Venezuela
Jinkis Khan	Gengis Khan
Fanadhiyaam	Vanadio
Koroomiyaam	Cromo
Faras	Equus caballus
Amistardam	Amsterdam
Hub	Arma
Xayawaan	Animalia
Surinam	Suriname
Manganiis	Manganese
Paraguay	Paraguay
Guyana	Guyana
Fan	Arte
Ikwadoor	Ecuador
Reheniyaam	Renio
Kolombiya	Colombia
Kobalti	Cobalto
Tungsten	Tungsteno
Nikel	Nichel
Boliifia	Bolivia
Osmiyaam	Osmio
Groningen	Groninga (provincia)
Kober	Rame
Beer	Plantæ
Sinki	Zinco
Leonardo da Vinci	Leonardo da Vinci
Boqoshaa	Fungi
Jamayka	Giamaica
Friesland	Frisia (Paesi Bassi)
Drenthe	Drenthe
Overijssel	Overijssel
Guatemala	Guatemala
Gelderland	Gheldria (provincia)
Utrecht	Utrecht (provincia)
Bahamas	Bahamas
Dooro	Gallus gallus domesticus
Antigua iyo Barbuda	Antigua e Barbuda
Hawaay	Hawaii
Dominika	Dominica
Doofaar	Sus scrofa domesticus
Haiti	Haiti
El Salfador	El Salvador
Iiraan	Iran
Ciraaq	Iraq
Xikmad	Saggezza
Kosta Rika	Costa Rica
Israaiil	Israele
Magaalada Utrecht	Utrecht
Banama	Panamá
Yemen	Yemen
Virus	Virus (biologia)
Urdun	Giordania
Nikaragua	Nicaragua
Florida	Florida
Qargistan	Kirghizistan
Kuwayt	Kuwait
Laos	Laos
Lubnaan	Libano
Jasiirada Maldiif	Maldive
Ameerika	America
Lo'	Bos taurus
Malaysiya	Malesia
Burma	Birmania
Nebal	Nepal
Cumaan	Oman
Bakistaan	Pakistan
Qatar	Qatar
Ciyaarta Teeniska	Tennis
Sacuudi Carabiya	Arabia Saudita
Siri Lanka	Sri Lanka
Suuriya	Siria
Gaaliyaam	Gallio (elemento chimico)
Tadsjikistan	Tagikistan
Pokemon	Pokémon
Taywan	Taiwan
YouTube	YouTube
Jermaaniyaam	Germanio
Tayland	Thailandia
Tareen	Treno
Aarsenik	Arsenico
Turkmenistan	Turkmenistan
Seleniyaam	Selenio
Iridiyaam	Iridio
Imaaraatka Carabta	Emirati Arabi Uniti
Boromiin	Bromo
Balatiniyaam	Platino
Fiyetnam	Vietnam
Charlie Chaplin	Charlie Chaplin
Koonfur Kuuriya	Corea del Sud
Kiribtoon	Kripton
Afgaanistan	Afghanistan
Gangnam Style	Gangnam Style
Rubiidhiyaam	Rubidio
Dahab	Oro
Kanaalka Suweys	Canale di Suez
Bangladesh	Bangladesh
Maali	Mali
Sokrades	Socrate
Angola	Angola
Butaan	Bhutan
Twitter	Twitter
Barunay	Brunei
Tansaaniya	Tanzania
Meerkuri	Mercurio (elemento chimico)
Roald Amundsen	Roald Amundsen
Harry Mulisch	Harry Mulisch
Filibiin	Filippine
Jamhuuriyadda Bartamaha Afrika	Repubblica Centrafricana
Cirifka Koonfur	Polo sud
Cirifka waqooyi	Polo nord
Isxaaq Newton	Isaac Newton
Albert Einstein	Albert Einstein
Istoroontiyaam	Stronzio
Itriyaam	Ittrio
Bismuth	Bismuto
Jaale	Giallo
Togo	Togo
Tunisiya	Tunisia
Saambiya	Zambia
Simbaabwi	Zimbabwe
Beijing	Pechino
Koonfur Suudaan	Sudan del Sud
Benin	Benin
Botswana	Botswana
Burkina Faso	Burkina Faso
Burundi	Burundi
Komoros	Comore
Jamhuuriyadda Kongo	Repubblica del Congo
Jamhuuriyada Dimuqaraadiga Kongo	Repubblica Democratica del Congo
Jabuuti	Gibuti
Boloniyaam	Polonio
Ikweetiga Guinea	Guinea Equatoriale
Eratareya	Eritrea
New Delhi	Nuova Delhi
Astatiin	Astato
Gabon	Gabon
Mahatma Gandhi	Mahatma Gandhi
Gambia	Gambia
Guinea	Guinea
Guinea-Bissau	Guinea-Bissau
Xeebta Foolmaroodi	Costa d'Avorio
Kamiruun	Camerun
Kab Ferde	Capo Verde
Lesotho	Lesotho
Liberia	Liberia
Libiya	Libia
Madagaskar	Madagascar
Malaawi	Malawi
Mauritania	Mauritania
Mauritius	Mauritius
Marooko	Marocco
Musanbiig	Mozambico
Nambiya	Namibia
Nayjar	Niger
Nayjeeriya	Nigeria
Yugandha	Uganda
Ruwanda	Ruanda
Sirkooniyaam	Zirconio
Sao Tome iyo Prinsipe	São Tomé e Príncipe
Sinigaal	Senegal
Seyshelles	Seychelles
Sierra Leone	Sierra Leone
Soomaaliya	Somalia
Niyobiyaam	Niobio
Julius Caesar	Gaio Giulio Cesare
Suudaan	Sudan
Swasiland	Swaziland
Qaansa Roobaad	Arcobaleno
Molybdenum	Molibdeno
Teknetiyaam	Tecnezio
Qaramada Midoobay	Organizzazione delle Nazioni Unite
Juquraafi	Geografia
Wadno	Cuore umano
Maskax	Cervello
Maqaar	Pelle
Midab	Colore
Rutheniyaam	Rutenio
Roodhiyaam	Rodio
Baluug	Blu
Baladiyaam	Palladio (elemento chimico)
Naxaas	Argento
Kaadmiyaam	Cadmio
Limburg	Limburgo (Paesi Bassi)
Tin (curiye)	Stagno (elemento chimico)
Antimony	Antimonio
Teluriyaam	Tellurio
Waqooyiga Brabant	Brabante Settentrionale
Aaydhiin	Iodio
Siinoon	Xeno
Kaasiyaam	Cesio (elemento chimico)
Baariyaam	Bario
Haafniyaam	Afnio
Aktiiniyaam	Attinio
Tantalum	Tantalio
Bill Clinton	Bill Clinton
Raadhiyaam	Radio (elemento chimico)
Raadhoon	Radon
Lorraine	Lorena (regione francese)
Buerto Riko	Porto Rico
Niedersachsen	Bassa Sassonia
Lombardia	Lombardia
Qudus	Gerusalemme
Rutherfordium	Rutherfordio
Dubniyaam	Dubnio
Siiborgiyaam	Seaborgio
Badweynta Hindiya	Oceano Indiano
Kosofo	Kosovo
Badda Karabiya	Mare Caraibico
Bohriyaam	Bohrio
Hasiyaam	Hassio
Meitneriyaam	Meitnerio
Darmstadtiyaam	Darmstadtio
Roentgeniyaam	Roentgenio
Dortmund	Dortmund
Ununtriyaam	Ununtrio
Lifermoriyaam	Livermorio
Ununoktiyaam	Ununoctio
Maastricht	Maastricht
Jiilaal	Inverno
Gu	Primavera
Xagaa	Estate
Dayr	Autunno
Sadaam Xuseen	Saddam Hussein
Usaama bin Laadin	Osama bin Laden
Caarcaaro	Araneae
Miro	Frutto
Lacagta	Denaro
Xasharaad	Insecta
Faladimir Lenin	Lenin
Uetersen	Uetersen
Augustus Octavian	Augusto
Microsoft Windows	Microsoft Windows
Jibraltaar	Gibilterra
Nokia	Nokia
Baabuur	Autovettura
Juventus FC	Juventus Football Club
Texas	Texas
Bruno Mars	Bruno Mars
Sasiiliya	Sicilia
Sardiiniya	Sardegna
Fuuqbax	Malattia di Crohn
Buenos Aires	Buenos Aires
Tokyo	Tokyo
Barcelona	Barcellona
Abidjan	Abidjan
Minnesota	Minnesota
Baqdaad	Baghdad
Isuduwaha Waqtiga Caalamiga	Tempo coordinato universale
AC Milan	Associazione Calcio Milan
Buuri	Tabacco
Internet Explorer	Internet Explorer
Sigaar	Sigaretta
Nayl armistaroong	Neil Armstrong
Maxamed Faarax	Mohamed Farah
München	Monaco di Baviera
Fiyena	Vienna
Kobanhaygan	Copenaghen
Stockholm	Stoccolma
Helsinki	Helsinki
Dublin	Dublino
Bratislava	Bratislava
Budapest	Budapest
Frankfurt	Francoforte sul Meno
Lanthanum	Lantanio
Kitaabka quduska	Bibbia
Phnom Penh	Phnom Penh
Ho Chi Minh City	Ho Chi Minh (città)
Luteetiyaam	Lutezio
Mida Rumeed Kaniisada Ciise	Vera Chiesa di Gesù
Ingiriis (luqad)	Lingua inglese
Bangkok	Bangkok
Dong Hoi	Dong Hoi
Concepción	Concepción (Cile)
Franck Ribéry	Franck Ribéry
Ottawa	Ottawa
Dayaxa Cirjeex	Satelliti naturali di Giove
Juba	Giuba (Sudan del Sud)
Końskowola	Końskowola
Dar es Salaam	Dar es Salaam
Khartuum	Khartum
Dayaxa raage	Satelliti naturali di Saturno
2000	2000
2003	2003
2002	2002
2001	2001
2012	2012
2011	2011
2010	2010
2009	2009
2013	2013
2014	2014
2008	2008
2004	2004
2005	2005
2006	2006
2007	2007
1900	1900
1901	1901
Charles De Gaulle	Charles de Gaulle
1906	1906
1908	1908
1909	1909
1992	1992
1991	1991
1990	1990
1993	1993
1994	1994
1995	1995
1996	1996
1910	1910
1911	1911
1912	1912
1913	1913
1914	1914
1997	1997
1998	1998
1999	1999
1918	1918
Cunto	Alimento
Mas	Serpentes
Dayaxa docay	Satelliti naturali di Nettuno
Dashiishe	1º gennaio
1920	1920
1919	1919
1921	1921
Georges Pompidou	Georges Pompidou
Malmö	Malmö
Birmingham	Birmingham
Microsoft	Microsoft
Borotoon	Protone
Kurów	Kurów
Kimisteri	Chimica
Robin van Persie	Robin van Persie
27	27
1989	1989
1988	1988
1987	1987
1986	1986
1985	1985
1984	1984
1983	1983
1982	1982
1981	1981
1980	1980
Muqdisho	Mogadiscio
Sana'a	Sana’a
1970	1970
1971	1971
1972	1972
1973	1973
1974	1974
1975	1975
1976	1976
1977	1977
1978	1978
1979	1979
1969	1969
18 Abriil	18 aprile
25 Abriil	25 aprile
26 Abriil	26 aprile
Dayax	Satellite naturale
Kristian Wulff	Christian Wulff
15 Meey	15 maggio
SSC Napoli	Società Sportiva Calcio Napoli
1968	1968
1967	1967
1966	1966
1965	1965
1964	1964
27 Juun	27 giugno
Kubadda Cagta	Calcio (sport)
AS Roma	Associazione Sportiva Roma
1963	1963
Holokost	Olocausto
1962	1962
Michael Jackson	Michael Jackson
Bogota	Bogotá
29 Diseembar	29 dicembre
Quito	Quito
Adhi	Capra hircus
21 Oktoobar	21 ottobre
Paramaribo	Paramaribo
Kanbera	Canberra
Sydney	Sydney
Cagaar	Verde
Gaduud	Rosso
Perth	Perth (Australia Occidentale)
Galbeed Australia (gobol)	Australia Occidentale
New South Wales	Nuovo Galles del Sud
Wabiga Niil	Nilo
Jini	Jinn
Wabiga Nijer	Niger (fiume)
Rabat	Rabat
Algiers	Algeri
Tunis	Tunisi
Triboli	Tripoli
Rede Globo	Rede Globo
Jabuuti (magaalo)	Gibuti (città)
Tahraan	Teheran
Addis Abeba	Addis Abeba
Ankara	Ankara
Asmara	Asmara
Nijamiina	N'Djamena
Niamey	Niamey
Nawakshot	Nouakchott
1961	1961
Bamako	Bamako
Belgaraad	Belgrado
Dakar	Dakar
Banjul	Banjul
Konakri	Conakry
Bissau	Bissau
Category:Template	Categoria:Template
Monrofia	Monrovia
Braia	Praia
1960	1960
Akara	Accra
Dimishiq	Damasco
Yamoussoukro	Yamoussoukro
Faransiis Guyana	Guyana francese
Ougadougou	Ouagadougou
Freetown	Freetown
Abuja	Abuja
Lome	Lomé
Borto-Novo	Porto-Novo
Yawunde	Yaoundé
Malabo	Malabo
Librefille	Libreville
Bangui	Bangui
Kinshasa	Kinshasa
Barasafille	Brazzaville
Bujumbura	Bujumbura
Kigali	Kigali
Dodoma	Dodoma
Nayroobi	Nairobi
Lilongwe	Lilongwe
Lusaka	Lusaka
Qorax madoobaad	Eclissi solare
Mabuto	Maputo
Kambaala	Kampala
Luanda	Luanda
Moroni	Moroni (Comore)
Mabane	Mbabane
Maseru	Maseru
Dugsi	Scuola
Antananarifo	Antananarivo
Jaamacad	Università
Gaborone	Gaborone
Harare	Harare
Pretoria	Pretoria
Bort Lois	Port Louis
Sao Tome	São Tomé
Windhoek	Windhoek
Wikipedia:Bacaadka	Wikipedia:Pagina delle prove
Fiktoria	Victoria (Seychelles)
Guri	Casa
Kombuyuuterka Dhabta	Computer portatile
Computer Hardware	Hardware
Aljebra	Algebra
Webiyada	Fiume
Osasko	Osasco (San Paolo)
Garoonka ee Dong Hoi	Aeroporto di Dong Hoi
Curitiba	Curitiba
Pangea	Pangea
Keyn	Foresta
Anne Frank	Anna Frank
Shilin Soomaali	Scellino somalo
Confucius	Confucio
Category:Taariikhda Ciraaq	Categoria:Storia dell'Iraq
Corbin Bleu	Corbin Bleu
Category:Xisaab	Categoria:Matematica
Jasiiradaha Feroe	Fær Øer
Maxamed Morsi	Mohamed Morsi
Euro	Euro
Bada Dhexe	Mar Mediterraneo
Haashim	Banu Hashim
Masiixiyad	Cristianesimo
Windows 8	Windows 8
Template:Dalalka Aasiya	Template:Asia
Céline Dion	Céline Dion
Qaaradaha	Continente
Adelaide	Adelaide (Australia)
Shimbir	Aves
Bilaha	Mese
Mustafa Kemal Atatürk	Mustafa Kemal Atatürk
1948	1948
Jeejniya	Cecenia
1949	1949
Garoosni	Groznyj
Huang Xianfan	Huang Xianfan
1956	1956
1941	1941
1945	1945
1958	1958
1926	1926
1947	1947
1944	1944
1952	1952
Bill Gates	Bill Gates
Encyclopedia	Enciclopedia
DVD	DVD
Bogga Hore	Pagina principale
CPU	CPU
1959	1959
Template:Maqaal Cusub	Template:Voce di qualità
Dhesibel	Decibel
Kubadda Koleyga	Pallacanestro
Kab town	Città del Capo
Bada Qaswiin	Mar Caspio
Harta Fiktooriya	Lago Vittoria
Harada malaawi	Lago Malawi
Salvador Dalí	Salvador Dalí
Finsent van Gogh	Vincent van Gogh
Hokusai	Katsushika Hokusai
Mishelangelo	Michelangelo Buonarroti
Bablo bekaso	Pablo Picasso
Rembrandt van Rijn	Rembrandt
Eminem	Eminem
Bas	Autobus
Baabiyloon	Babilonia
Katalooniya	Catalogna
Samarqanda	Samarcanda
Bukhaara	Bukhara
Mekka	La Mecca
Che Guvara	Che Guevara
Mao Zedong	Mao Tse-tung
Kabul	Kabul
Luqada Tamil-ka	Lingua tamil
Filasoofiyada	Filosofia
50 Cent	50 Cent
Dr. Dre	Dr. Dre
Snoop Dogg	Snoop Dogg
Shaax	Tè
Tupac Shakur	Tupac Shakur
Xidig-dhul	Erinaceinae
1507	1507
Shuuciyad	Comunismo
Amadeyo afogadro	Numero di Avogadro
Liberalinimo	Liberalismo
Wadan	Paese (area geografica)
Qaran	Nazione
Jow Bayden	Joe Biden
Hillary Clinton	Hillary Clinton
Dabaal	Nuoto
Category:Xiddigis	Categoria:Astronomia
1542	1542
1543	1543
Jaan Jaak Rosoo	Jean-Jacques Rousseau
Saxaara	Deserto del Sahara
Hambeegar	Hamburger
Shaydaanka	Diavolo
1606	1606
Maktabad	Biblioteca
FC Barcelona	Futbol Club Barcelona
Midowga afrika	Unione africana
Siyaasadda,	Politica
Jaamacada Carabta	Lega araba
Dimoqraadi	Democrazia
Hay'ada laanqayrta cas	Croce Rossa e Mezzaluna Rossa Internazionale
Gaashaanbuurta NATO	Organizzazione del Trattato dell'Atlantico del Nord
Qin Shi Huang	Qin Shi Huang
Bariga Dhexe	Medio Oriente
Jamhuriyadda	Repubblica
Hantiwadaag	Socialismo
Dowlad	Stato
Xisbi	Partito politico
Kilimanjaaro	Kilimangiaro
Kristoffer Kolombus	Cristoforo Colombo
Rixlaat Ibn Batuuta	Ibn Battuta
Kanaalka Banama	Canale di Panama
Dheg	Orecchio
San	Naso
Muruq	Muscolo
Hees	Canzone
Kaneeco	Culicidae
Libaax Badeed	Selachimorpha
Geel	Camelus
Naasley	Mammalia
Quraansho	Formicidae
Shini	Anthophila
Software	Software
Af-Holandees	Lingua olandese
DNA	DNA
Nuucyada dhirta	Specie
Hooyo	Madre
Aabe	Padre
Waalid	Genitore
Gaadiidka Dadweynaha	Trasporto
Debian	Debian
1669	1669
1670	1670
1671	1671
1672	1672
1673	1673
1674	1674
1675	1675
1676	1676
1677	1677
1678	1678
1679	1679
1680	1680
1856	1856
Af-Ruush	Lingua russa
Faladimir Putin	Vladimir Putin
Dastuur	Costituzione
Dalalka Kommonwels	Commonwealth delle nazioni
OPEC	Organizzazione dei Paesi esportatori di petrolio
Rooti	Pane
UNESCO	Organizzazione delle Nazioni Unite per l'Educazione, la Scienza e la Cultura
Baaqa Caalamiga ee Xuquuqda Aadanaha	Dichiarazione universale dei diritti umani
1796	1796
1797	1797
1899	1889
Sawaaxili	Lingua swahili
1893	1893
Unug	Cellula
Dhiig	Sangue
Qolfoof	Scheletro (anatomia)
Sambab	Polmone
Hab Neefsi	Apparato respiratorio
Habdhiska Taranka	Apparato genitale
Af-Romani	Lingua romena
Roob	Pioggia
Dhulgariir	Terremoto
Ibn Siinaa	Avicenna
Nelson Mandela	Nelson Mandela
Martin Luther King,	Martin Luther King
Ensiim	Enzima
Borotiin	Proteine
Daad	Inondazione
Tsunami	Maremoto
Fulkaano	Vulcano
Caad	Nuvola
Tirignoometeri	Trigonometria
Joomitiri	Geometria
Qarnigii 2aad	II secolo
Qarnigii 1aad	I secolo
Dhaqaale	Economia
Warshad	Industria
Farta laatiinka	Alfabeto latino
Suugaan	Letteratura
Category:Faransiiska	Categoria:Francia
Category:Muusig	Categoria:Musica
Kun Habeen Iyo Habeen	Le mille e una notte
Category:Suugaanta	Categoria:Letteratura
Category:Gabayada	Categoria:Poesia
Waxbarasho	Educazione
Qoys	Famiglia
Hugo Chavez	Hugo Chávez
Nin	Uomo (genere)
Guur	Matrimonio
Midab Takoor	Razzismo
Adoon	Schiavismo
Dagaal Sokeeye	Guerra civile
Cumar	ʿUmar ibn al-Khaṭṭāb
Suldaan Suleymaan kan 1aad	Solimano il Magnifico
Bun	Caffè
Caano	Latte
Buur	Montagna
Salaaxudiin al-Ayyuubi	Saladino
Karaaji	Karachi
Riyaal Madrid	Real Madrid Club de Fútbol
Dagaalkii qaboobaa	Guerra fredda
Seoul	Seul
Tomas Edison	Thomas Edison
Michael Faraday	Michael Faraday
Internet protocol	Internet Protocol
HTML	HTML
Af-Iswiidhan	Lingua svedese
Muxamed bin Muuse al-Khwarizmī	Muhammad ibn Musa al-Khwarizmi
Karl Marx	Karl Marx
Nabi Muuse C.S.	Mosè
Aqoon	Conoscenza
Naas	Mammella
Atom	Atomo
Ileys	Luce
Af Giriig	Lingua greca
Operating system	Sistema operativo
Naf	Anima
Af-Faarsi	Lingua persiana
Diin	Religione
Nabi Ibraahiim C.S.	Abramo
Saladh	Insalata
Yuhuuda	Ebraismo
Af-Hebrow	Lingua ebraica
Ibn Khalduun	Ibn Khaldun
Beer (xubin)	Fegato
Bakeyle	Coniglio
Cilminafsi	Psicologia
Badweyn	Oceano
Gootama buuda	Gautama Buddha
Muxamed	Maometto
BBC	BBC
Shahrukh Khan	Shah Rukh Khan
Al-Ghazaali	Al-Ghazali
Gerald Ford	Gerald Ford
Shiica	Sciismo
Suufi	Sufismo
Carab	Lingua (anatomia)
Chelsea FC	Chelsea Football Club
Arsenal F.C.	Arsenal Football Club
Ganac	Pancreas
Qolfoofta Dadka	Scheletro (anatomia umana)
Qoor	Collo
Af	Bocca
Elizabeth II	Elisabetta II del Regno Unito
Caajiska	Affaticamento
Schiphol	Aeroporto di Amsterdam-Schiphol
Haarlem	Haarlem
Ronald Reagan	Ronald Reagan
Af-Zulu	Lingua zulu
Foosto	Botte
Sabool	Povertà
Gordon Brown	Gordon Brown
Jadwalka Curiyayaasha	Tavola periodica degli elementi
Robert Mugabe	Robert Mugabe
Xamaam(Shinbir)	Columbidae
Bakteeri	Bacteria
Geed	Albero
Canab	Uva
Malab	Miele
Hilib	Carne
Barandho	Solanum tuberosum
Khudaar	Verdura
Robot	Robot
Makiinad	Macchina
Saxaafad	Giornalismo
Taleefoon	Telefono
Dhaqan	Cultura
RNA	RNA
Xidigisyahan	Astronomo
Habdhiska Wareega Dhiiga	Apparato circolatorio
Mindhicirka weyn	Intestino crasso
Mindhicirka yar	Intestino tenue
Ibn Haytham	Alhazen
Isku dhis	Composto chimico
Sharci dajinta	Potere legislativo
Windows 7	Windows 7
Boqolleey	Percentuale
Windows Vista	Windows Vista
Fidel Castaro	Fidel Castro
Category:Barasiil	Categoria:Brasile
Tamar	Energia
Abala-abalayn bayoloji	Classificazione scientifica
Awood	Forza
Cufisjiidad	Interazione gravitazionale
Cuf	Massa (fisica)
Bir	Metallo
Hawo	Gas
Dareere	Liquido
Adke	Solido
Bushkuleeti	Bicicletta
Markab	Nave
Beeraha	Agricoltura
Cudbi	Cotone (fibra)
Tiknolajiga nano	Nanotecnologia
Xaansho	Carta
Bac	Materie plastiche
Bed	Area
Lambar	Numero
Kiilogaraam	Chilogrammo
Cristiano Ronaldo	Cristiano Ronaldo
Mitir	Metro
Ilbiriqsi	Secondo
Galley	Zea mays
Kelvinka	Kelvin
Dalalka	Stati del mondo
Ludwik Lejzer Zamenhof	Ludwik Lejzer Zamenhof
Mesobotaamiya	Mesopotamia
Buti	Ursidae
Britney Spears	Britney Spears
Habdhiska Dheefshiidka	Digestione
Habka Samayska Cuntada	Fotosintesi clorofilliana
Boqortooyo	Re
Qamadi	Triticum
Kalandar	Calendario
Dhagool	Sordità
Cudur	Malattia
Niikotiin	Nicotina
Malaariyo	Malaria
Cunto xumida	Malnutrizione
Benseliin	Penicillina
Nantes	Nantes
AIDS	AIDS
Sokorow	Diabete mellito
Template:Location map Yemen	Template:Mappa di localizzazione/YEM
Mona Lisa	Gioconda
Horgale (Fiisikis)	Sistema internazionale di unità di misura
Burj Khalifa	Burj Khalifa
Gidaarka Shiinaha	Grande muraglia cinese
Abyoone	Numero intero
Kubad	Sfera
Dawladii Cabaasiyiinta	Abbasidi
Dawlada Cosmaniya	Impero ottomano
Koronto	Elettricità
Seef	Spada
Pawlo Kuwelho	Paulo Coelho
Stephan El Shaarawy	Stephan El Shaarawy
Liin	Citrus × sinensis
Af-Soomaali	Lingua somala
Aljaziira	Al Jazeera
Hal-xeraale	Rompicapo
Carabi	Lingua araba
Xorta ah	Contenuto libero
Baar	Arecaceae
Dollar	Dollaro
Ra'iisul wasaare	Primo ministro
Araga	Ottica
Calan	Bandiera
Qalin Qori	Matita
Saabaan	Arredamento
Template:Location map Sudan	Template:Mappa di localizzazione/SDN
Template:Location map Eritrea	Template:Mappa di localizzazione/ERI
Template:Location map Ethiopia	Template:Mappa di localizzazione/ETH
Template:Location map Djibouti	Template:Mappa di localizzazione/DJI
Template:Location map Somalia	Template:Mappa di localizzazione/SOM
Template:Location map Nigeria	Template:Mappa di localizzazione/NGA
Template:Location map Uganda	Template:Mappa di localizzazione/UGA
Geri	Giraffa camelopardalis
Faruur	Labbro
Shaarbo	Baffo (peli del viso)
Midowga Sofiyet	Unione Sovietica
Qolofta kore ee Dhulka	Crosta terrestre
Lil Wayne	Lil Wayne
FC Bayern München	Fußball-Club Bayern München
Queen	Queen
Kanye West	Kanye West
Huguri	Gola (anatomia)
Wikipedia:Maqaallo Xul Ah	Wikipedia:Vetrina
Template:Link FA	Template:Link V
Aduunka	Mondo
Wikipedia:Goob	Wikipedia:Bar
Nanjing	Nanchino
Mayotte	Mayotte
Goobo	Circonferenza
Cesc Fàbregas	Cesc Fàbregas
Mobile	Telefono cellulare
Goronyo	Struthio camelus
Kuuriya	Corea
Manchester	Manchester
1000	1000
999	999
Yeey	Canis lupus
1955	1955
1954	1954
1953	1953
1951	1951
1950	1950
1946	1946
1943	1943
1942	1942
1940	1940
1939	1939
1938	1938
1937	1937
1936	1936
Manchester United FC	Manchester United Football Club
1935	1935
1934	1934
Axdiga Cusub	Nuovo Testamento
Qafqaas	Caucaso
Sagaal	9 (numero)
Dabaqaroof	Scorpiones
Koobka Adduunka	Campionato mondiale di calcio
Boolo	Pelecanus
Macdin Alkaliini ah	Metalli alcalini
Macdin dhuleed ah	Metalli alcalino terrosi
Rafael Correa	Rafael Correa
Transitional Metal	Metalli del blocco d
Bir la Mood	Semimetallo
Bir Ma Ahe	Non metallo
Guruubka 17	Alogeni
Neefta Gobta	Gas nobili
5	5
4	4
3	3
Boqorad	Regina regnante
2	2
Buqarest	Bucarest
Louvre	Museo del Louvre
Motorhead	Motörhead
Dameer	Equus asinus
Wikipedia:Maqaal Cusub	Wikipedia:Voci di qualità
6	6
Axdigii Hore	Antico Testamento
Saddax-xagal	Triangolo
Lady Gaga	Lady Gaga
Luqada Hindo Yurub	Lingue indoeuropee
Breinigerberg	Breinigerberg
Muammar Qadaafi	Mu'ammar Gheddafi
Shabeel	Panthera tigris
Francesco Totti	Francesco Totti
PSY	PSY (rapper)
Nissan	Nissan Motor Co.
Walhade	Pendolo
Samsung	Samsung
Skandinafiyen	Scandinavia
Aruba	Aruba
Smartphone	Smartphone
Shidaal	Petrolio
Isuduwe Habka Juqraafiga	Coordinate geografiche
Banki	Banca
1	1
10	10
20	20
30	30
Abkhazia	Abcasia
40	40
9	9
7	7
8	8
Todoba	7 (numero)
Sideed	8 (numero)
Todobaad	Settimana
Deero	Cervidae
Baraf	Ghiaccio
Toon	Allium sativum
Musée d'Orsay	Museo d'Orsay
Anthroboloji	Antropologia
Badacas	Mar Rosso
13	13
Koonfur Ossetia	Ossezia del Sud
Ulan Bator	Ulan Bator
51	51
Jasiirad	Isola
Cad	Bianco
Madaw	Nero
37	37
900	900
Lordi	Lordi
Basal	Allium cepa
Lix	6 (numero)
700	700
Yaanyo	Solanum lycopersicum
George H. W. Bush	George H. W. Bush
68	68
89	89
11	11
Quang Binh	Provincia di Quang Binh
Entrena	Entrena
Dhulbare	Equatore
NASA	NASA
Benito Mussolini	Benito Mussolini
15	15
14	14
17	17
500	500
150	150
Qaamuus	Dizionario
Bermuda	Bermuda
Madax	Testa
Wellington	Wellington
23	23
800	800
Heesta qaranka	Inno nazionale
42	42
Afarta jiho	Punto cardinale
18	18
Nuurad	Calcare
19	19
16	16
21	21
26	26
41	41
32	32
33	33
Falastiin	Palestina
Valletta	La Valletta
200	200
38	38
43	43
39	39
24	24
79	79
61	61
104	104
29	29
102	102
100	100
Haramcad	Acinonyx jubatus
Afarta xilli	Stagione
101	101
105	105
108	108
Dhuxul Dhagax	Carbone
22	22
46	46
25	25
153	153
156	156
31	31
28	28
Liverpool	Liverpool
85	85
88	88
76	76
54	54
60	60
47	47
Guumees	Strigiformes
Nederlaan Antiilis	Antille Olandesi
Bahda Bisada	Felidae
Ambeer	Ampere
Isotope	Isotopo
Göteborg	Göteborg
Culeys	Forza peso
Geed Timir	Phoenix dactylifera
Burris	Martello
Racibórz	Racibórz
Odense	Odense
Kobe Bryant	Kobe Bryant
Luqadaha Berberiga	Lingua berbera
600	600
400	400
300	300
Tilburg	Tilburg
Dayax gacmeed	Satellite artificiale
Taylor Swift	Taylor Swift
Khaalid bin Waliid	Khalid ibn al-Walid
Bariga Afrika	Africa orientale
Fiat	FIAT
Bartamaha Ameerika	America Centrale
Af-Cafari	Lingua afar
Magrib	Maghreb
Amxaari	Lingua amarica
36)	36
Tin	Pelo
Wareeg	Perimetro
Dhar	Tessuto
Kacdoonka masar	Rivoluzione egiziana del 2011
Willis Tower	Willis Tower
Kacbada	Kaaba
Beatriks	Beatrice dei Paesi Bassi
Isuzu	Isuzu
Dublad	Imbuto
159	159
107	107
103	103
152	152
240	240
197	197
70	70
Duqa	Sindaco
81	81
69	69
87	87
65	65
66	66
67	67
55	55
34	34
44	44
35	35
64	64
151	151
155	155
50	50
260	260
45	45
49	49
230	230
Zhengzhou	Zhengzhou
154	154
52	52
82	82
84	84
73	73
72	72
62	62
71	71
75	75
74	74
83	83
78	78
77	77
90	90
80	80
91	91
190	190
109	109
53	53
270	270
Madaxweyne	Presidente
63	63
86	86
401	401
99	99
98	98
110	110
137	137
138	138
140	140
130	130
210	210
220	220
Dell	Dell
180	180
158	158
157	157
106)	106
48	48
97	97
Yuumbi	Istiophoridae
56	56
93	93
Alofi	Alofi (città)
57	57
Jamestown	Jamestown (Sant'Elena)
170	170
171	171
172	172
58	58
59	59
139	139
134	134
135	135
96)	96
92	92
133	133
176	176
131	131
Fowdo	Anarchia
Jasiirad Dhuleedka Carabta	Penisola araba
250	250
280	280
290	290
Mindi	Coltello
Masaajid	Moschea
Akon	Akon
Dumnad	Domino (gioco)
174	174
International Standard Book Number	ISBN
132	132
178	178
Luqadaha Tashaadiga	Lingue ciadiche
Drake	Drake (rapper)
Luqadaha Kushiitiga	Lingue cuscitiche
Afguri	Dialetto
95	95
94	94
257	257
Biriq	Fulmine
Gacan	Mano
Luqadaha Omotik	Lingue omotiche
Af-Oromo	Lingua oromo
Caleen	Foglia
Jilaa	Attore
Niue	Niue
Luqadaha Semitiga	Lingue semitiche
Justin Bieber	Justin Bieber
Xusni Mubaarak	Hosni Mubarak
Af-Tigrinya	Lingua tigrina
Af-Tigre	Lingua tigrè
Dhululubo	Cilindro (geometria)
Subag	Burro
Yaasir Carafaat	Yasser Arafat
Fara-ka hadal	Lingua dei segni
136	136
Injiil	Vangelo
Alexander Graham Bell	Alexander Graham Bell
Tasmaniya	Tasmania
Rotterdam	Rotterdam
Saabuun	Sapone
Cabdillahi ibn Cabdi al Mudalib	Abd Allah ibn Abd al-Muttalib
Mošovce	Mošovce
Zeyd Binu Xaaritha	Zayd ibn Haritha
Shakira	Shakira
Jaamacadda Oxford	Università di Oxford
Maxamuud Axmadinajaad	Mahmud Ahmadinejad
CD	Compact disc
Al-Qaacida	Al-Qaida
Maxamed Al-faatex	Maometto II
Jeer	Hippopotamus amphibius
Far	Dito
Furaat	Eufrate
Gacanka Faarsiga	Golfo Persico
Cilmiga bulshada	Scienze sociali
Somaliland	Somaliland
Ciida sanadka cusub	Capodanno
Babaay	Carica papaya
Brisbane	Brisbane
Fiitamiin	Vitamine
Towraad	Torah
Koonfur Joorjiya iyo Koonfurta Jasiiradaha Sanwij	Georgia del Sud e Isole Sandwich Meridionali
Maahmaah	Proverbio
Noemi	Noemi (cantante)
Website	Sito web
Ido	Lingua ido
Sumeer	Sumeri
Kolonbo	Colombo (città)
Dariishad	Finestra
Medina	Medina
Akkadiyaan	Lingua accadica
Booliis	Polizia
UEFA	Union of European Football Associations
Tigris	Tigri
Koonfur Australia (gobol)	Australia Meridionale
Baarlamaan	Parlamento
Maatar	Materia (fisica)
Jaamacadda Cambridge	Università di Cambridge
Fulinta (Dawlad)	Potere esecutivo
Hurdo	Sonno
Neefta	Asma
Doon	Imbarcazione
Queensland	Queensland
Mohammed ali Clay,	Muhammad Ali
Beyoncé Knowles	Beyoncé Knowles
Urur	Insieme
Siligo	Siligo
Riyo	Sogno
Bur	Farina
Dhigaha	Longitudine
Kimikal dibusocod	Reazione chimica
Den Haag	L'Aia
Goriila	Gorilla
Daylight saving time	Ora legale
Daanta galbeed	Cisgiordania
Maraykanka assalkoodii	Nativi americani
Siinaa	Penisola del Sinai
Albaab	Porta
Rihanna	Rihanna
Hargab Doofaar	Influenza suina
Cinjo	Unghia
Ugaadhsi	Caccia
Toshiro Mifune	Toshirō Mifune
Waji	Viso
Aleksander Fileming	Alexander Fleming
Musmaar	Chiodo
Nabi Suleymaan C.S.	Salomone
Yahoo	Yahoo!
AK-47	AK-47
Mowjad	Onda
Dhexroor	Diametro
Bare	Docente
Internet Movie Database	Internet Movie Database
Dalai Lama	Dalai Lama
Jilib (xubin)	Ginocchio
ISO 4217	ISO 4217
Tomas hobis	Thomas Hobbes
Campora San Giovanni	Campora San Giovanni
Jirjiroole	Chamaeleonidae
Cusmaan bin Cafaan	Othmàn ibn Affàn
Jaandi	Lega (metallurgia)
Nafto	Gasolio
Qare	Citrullus lanatus
Toban iyo shan	15 (numero)
Rikter Cabir	Scala Richter
Xamaas	Hamas
Ruhollah Khomeini	Ruhollah Khomeyni
Rajab Dayib Erdogaan	Recep Tayyip Erdoğan
Mug	Volume
Jamaal Cabdinaasir	Gamal Abd el-Nasser
Bluetooth	Bluetooth
Cali	Ali ibn Abi Talib
Marinka Gaza	Striscia di Gaza
Radio Studio 54 Network	Radio Studio 54 Network
Cabitaan	Bevanda
Qoori	Spiaggia
Qabaal	Ellisse
Hobart	Hobart
Dayax Gacmeed	Veicolo spaziale
Doorashada	Elezione
Iskudhufasho	Moltiplicazione
Saxaraha Galbeed	Repubblica Democratica Araba dei Sahrawi
.et	.et
Geeska Afrika	Corno d'Africa
Lisa Gerrard	Lisa Gerrard
Nabi Yaxye C.S.	Giovanni Battista
Jennifer Lopez	Jennifer Lopez
Faraq	Sottrazione
Breda (Netherlands)	Breda (Paesi Bassi)
Shuban	Diarrea
Nancy	Nancy
Honiara	Honiara
PH	PH
Asiyriya	Assiria
Qardhaas	Rombo (geometria)
Xayla Siilaasi	Hailé Selassié
Xalab	Aleppo
Big Ben	Big Ben
Dhererka Mowjadda	Lunghezza d'onda
Nabi Daa'uud C.S.	Davide
Borussia Dortmund	Ballspiel-Verein Borussia 09 Dortmund
Xidido	Radice (botanica)
Mole	Mole
Frank Lampard	Frank Lampard
Qallal	Epilessia
Baqal	Mulo
Garaam	Grammo
Shahaadah	Shahada
Gacanka Cadmeed	Golfo di Aden
Beeraha laalaada	Giardini pensili di Babilonia
Maas	Mosa (fiume)
Khadiija binti Khuweylad	Khadija bint Khuwaylid
Waraabe	Hyaenidae
Sariir	Letto
Madaxwayne kuxigeen	Vicepresidente
Cilmibaadhis	Ricerca scientifica
Faaranhaayt	Grado Fahrenheit
Dhuldaaqsiin	Savana
Dhogor	Lana
Toobin	Cono
Daliban	Talebani
MP3	MP3
Ismaamulka Falastiin	Autorità Nazionale Palestinese
.ke	.ke
Fernando Torres	Fernando Torres
Gar	Barba
Nabi	Profeta
Derbi	Muro (edilizia)
SMS	SMS
Yaxaas	Crocodylidae
Majladda Time	TIME
Dhedig	Femmina (biologia)
Farabadne	Chilopoda
Amedeo Avogadro	Amedeo Avogadro
Shambay	Felis silvestris
Federaalka	Stato federale
Sedex Geesoodka Bermuda	Triangolo delle Bermude
Arjen Robben	Arjen Robben
Xamid Karzai	Hamid Karzai
Lab	Maschio (biologia)
Rey mysterio	Óscar Gutiérrez
Dayax madoobaad	Eclissi lunare
Taxane	Matrice
Kayene	Caienna
John Cena	John Cena
Waran	Lancia (arma)
Busbus	Varicella
Provinces of Argentina	Province dell'Argentina
Garoonka Diyaaradaha ee Bole	Aeroporto di Addis Abeba-Bole
Dadka Berberiga	Berberi
Afganbi	Colpo di Stato
Burcad Badeed	Pirateria
RSS	RSS
Lacagta Meherka	Dote
Barbaroole	Parallelogramma
Leeb	Freccia
Chris Paul	Chris Paul
Awood Socota	Energia cinetica
Koor	Trapezio (geometria)
Qaanso	Arco (arma)
Amiibada	Amoeba
Zlatan Ibrahimović	Zlatan Ibrahimović
GSM	Global System for Mobile Communications
Dhaban	Guancia
Saint-Denis	Saint-Denis (Riunione)
Arsène Wenger	Arsène Wenger
Baabiylooniya	Civiltà babilonese
Muslim	Musulmano
Warqadda aqoonsiga	Documento di identità
Template:Commonscat	Template:Commonscat
Qoorgooye	Meningite
399	399
Iidi Amiin Daada	Idi Amin Dada
Kayseri	Kayseri
CNN	CNN
Drogbaa	Didier Drogba
Dhakhaatiirta Bilaaxuduudaa	Medici senza frontiere
Abwaan	Poeta
Manchester city	Manchester City Football Club
Ilaahay	Troms
John Dramani Mahama	John Dramani Mahama
Luqada Masaarida	Lingua egizia
Anatooliya	Anatolia
Nabi Ciise	Gesù nell'islam
Cudurka Ebola	Malattia da virus Ebola
Template:Taxobox	Template:Tassobox
Carly Rae Jepsen	Carly Rae Jepsen
Toyota	Toyota
Osmose	Osmosi
Af-Hawsa	Lingua hausa
Saxan	Piatto (stoviglia)
Mwai Kibaki	Mwai Kibaki
Jalaal Daalabaani	Jalal Talabani
Ismaaciil Cumar Geelle	Ismail Omar Guelleh
Nuur Al-Maliki	Nuri al-Maliki
Dileita Maxamed Dileita	Dileita Mohamed Dileita
Mark Rutte	Mark Rutte
Cumar Cabdirashiid Cali Sharmaarke	Omar Abdirashid Ali Sharmarke
Axmed Dafutoglu	Ahmet Davutoğlu
Robinho	Robinho
Bada Carbeed	Mar Arabico
Dhircun	Erbivoro
Calanka Denmark	Bandiera della Danimarca
Jay-Z	Jay-Z
Yuusuf Alqardaawi	Yusuf al-Qaradawi
Sahel	Sahel
Henry Kissinger	Henry Kissinger
Abu Hurayra	Abu Hurayra
Flums	Flums
Nabi Aadam C.S.	Adamo
Diego Milito	Diego Milito
Abti	Zio
Ilmo adeer	Cugino
Shumac	Candela (illuminazione)
Wikipedia:Sharaxaada Maqaalada Xulka Ah	Wikipedia:Vetrina/Segnalazioni
Wikipedia:Sharaxaada Maqaalada Cusub	Wikipedia:Voci di qualità/Segnalazioni
Dhalo	Bottiglia
Raqay	Tamarindus indica
Shabeelada Tamil	Tigri Tamil
Qaangaadh	Adulto
Enjerneer	Ingegnere
Gacanka Caqaba	Golfo di Aqaba
KwaZulu-Natal Province	KwaZulu-Natal
Hilibcun	Carnivoro
AFC Ajax	Amsterdamsche Football Club Ajax
Qaado	Cucchiaio
VOIP	Voice over IP
Jibriil	Arcangelo Gabriele
Astaamayn	Punteggiatura
Taksi	Taxi
Soqotra	Socotra
Timor	Timor
Almere	Almere
Xoor-dubbur	Mephitidae
Dooli	Mus musculus
Suul	Pollice (dito)
Mesut ozil	Mesut Özil
Ukun	Uovo (alimento)
HyperText	Ipertesto
Xeeb	Costa
Ibb	Ibb
Lobamba	Lobamba
Walxaha	Periodo della tavola periodica
Magarete2	Margherita II di Danimarca
Calanka jabuuti	Bandiera di Gibuti
Xareed	Acqua dolce
Calanka Suudaan	Bandiera del Sudan
Daanyeer	Hominoidea
Sodium Hydroxide	Idrossido di sodio
Xoolo	Bestiame
Cirid	Gengiva
Chalcogen	Elementi del gruppo 16
Tufaax	Malus
Shakaal	Ipotenusa
Biniktojiin	Gruppo dell'azoto
Lambedusa	Isola di Lampedusa
Manuel Neuer	Manuel Neuer
Jalmad	Bollitore
Eris	Eris
Wiz Khalifa	Wiz Khalifa
Agool	Forfora
Barfasoor	Professore
Maydhax	Xilema
Dhax kujir	Stato senza sbocco al mare
Andalus	Al-Andalus
Sako	Zakat
Dhadhan	Gusto
ICAO	Organizzazione internazionale dell'aviazione civile
.so	.so
Western Cape Province	Provincia del Capo Occidentale
Mario Balotelli	Mario Balotelli
Qiiq	Fumo
Eastern Cape Province	Provincia del Capo Orientale
Cerebellum	Cervelletto
Haaruun Alrashiid	Hārūn al-Rashīd
Kaftan	Barzelletta
Funaanad	Maglietta
Tangent	Tangente (geometria)
Niisaabuur	Nishapur
Khilaafada Islaamka	Califfato
Cadan	Aden
Het Wilhelmus	Het Wilhelmus
Universidade Federal de Minas Gerais	Università federale di Minas Gerais
Mpumalanga Province	Mpumalanga
Northern Cape Province	Provincia del Capo Settentrionale
Mamawdsaw	Mamoudzou
Gauteng Province	Gauteng
Lug	Zampa
Cagaarshow	Ittero
Du gamla, Du fria	Du gamla, du fria
Shaydaanimo	Satanismo
Canuuni	Durian
Limpopo Province	Provincia del Limpopo
LG	LG Group
Ogaden	Ogaden
Alexandre Pato	Alexandre Pato
Wabiga Jubba	Giuba (fiume)
Wabiga Shabeelle	Uebi Scebeli
Masago	Mallotus villosus
Marsho	Ingranaggio
Saynab bint Khuzayma	Zaynab bint Khuzayma
Saynab bint Jahsh	Zaynab bint Jahsh
Nabi Yuusuf	Giuseppe (patriarca)
One Direction	One Direction
Mille	Solvente
Ajay Devgan	Ajay Devgn
Herpesviruses	Herpesviridae
Degmo	Distretto
Tomahok (gantaal)	BGM-109 Tomahawk
Dambas	Cenere
Eduard Douwes Dekker	Multatuli
Yuusuf Islaam	Cat Stevens
Kiyaawe	Chiave (meccanica)
Awood Kaydsan	Energia potenziale
Chris Brown	Chris Brown
Universidade Estadual de Feira de Santana	Università di Stato di Feira de Santana
Aadan Cabdulle Cusmaan	Aden Abdulla Osman
Saylac	Zeila
Anopheles	Anopheles
Malawad	Retto
Universidade Federal da Bahia	Università federale di Bahia
Centro Federal de Educação Tecnológica de Minas Gerais	Centro Federal de Educação Tecnológica de Minas Gerais
Calanka Soomaaliya	Bandiera della Somalia
Dhuuso	Flatulenza
Free State Province	Free State
Oorfane	Orfanotrofio
Ubuc	Tronco (anatomia)
Meles Zenawi	Meles Zenawi
Nicki Minaj	Nicki Minaj
Wahaabi	Wahhabismo
Diffusion	Diffusione di materia
DDT	DDT (insetticida)
Cadnaan Oktaar	Adnan Oktar
Dheddin	Commiphora myrrha
Ibrahim Affelay	Ibrahim Afellay
Angry Birds	Angry Birds (serie)
Daango	Pop corn
Aadaan	Adhān
Usher	Usher
Hummaag noqod	Riflessione (fisica)
North West Province	Provincia del Nordovest (Sudafrica)
Lelystad	Lelystad
Midabada Asaasiga	Colore primario
Isnidaamis	Scabbia
Daaf	Congiuntivite
Abkow	Nonno
CAF	Confédération Africaine de Football
Hargeysa	Hargheisa
Nabiyada Islaamka	Profeti dell'islam
Xijaas	Hegiaz
Filibs	Philips
Kaliber	Calibro (armi)
Geed Hindi	Azadirachta indica
Jidh	Corpo (anatomia)
Qosol	Risata
Nektar	Nettare (botanica)
Mount kenya	Monte Kenya
Uunsi	Franchincenso
Jomo Kenyatta	Jomo Kenyatta
Gacan (Joomitiri)	Raggio (geometria)
Centimetre	Centimetro
Millimeter	Millimetro
Baadiye	Campagna
Fasuul Cabdalla Maxamed	Fazul Abdullah Mohammed
Portal:Taariikh	Portale:Storia
Hunguriga neefta	Trachea
Bowdo	Femore
Qaamo-qashiir	Parotite epidemica
Tiirarka Islaamka	Cinque pilastri dell'Islam
Fanaan	Cantante
Huulaaku Khan	Hulagu Khan
Dhuxul	Carbone vegetale
Shansho	Tibia (anatomia)
Saac (faah faahin)	Orologio da polso
Soon	Sawm
Alchemist(Buug)	L'alchimista (Coelho)
The Notorious B.I.G.	The Notorious B.I.G.
Sanab	Statua
Saadiyom bicarbonate	Bicarbonato di sodio
Nabi Ayuub C.S.	Giobbe
Fatima bint Muxamed	Fatima bint Muhammad
Baras	Vitiligine
Sumad xisaabed	Glossario della simbologia matematica
Ricir	Vertebra
Qol	Stanza (architettura)
Dhado	Umidità
Curiye	Elemento
Mucaawiye bin Abii Sufyaan	Mu'awiya ibn Abi Sufyan
Xasan Nasrallaah	Hassan Nasrallah
Mahathir Bin Maxamed	Mahathir Mohamad
Bidaar	Alopecia androgenetica
Aafda tahriibka	Traffico di esseri umani
KLM	KLM
Johan Rudolph Thorbecke	Johan Rudolph Thorbecke
Gabareey-maanyo	Sirena
Mitsubishi	Mitsubishi
Cashuura	Ashura
Memory card	Scheda di memoria
Daxal	Ruggine
Will.i.am	Will.i.am
Saxaro	Letame
Gaamur	Catrame
UFC	Ultimate Fighting Championship
Pitbull	Pitbull (rapper)
Aayad	Ayat
Tariikhda Shiikh Axmed Yaasiin	Ahmed Yassin
Saxaabi	Sahaba
Xaas	Moglie
Gows	Molare
Shanbal	Piatto (strumento musicale)
Harar	Harar
Dhismaha websiteka	Web design
Golcas	Gazella
Abuu Xaniifa	Abu Hanifa al-Nu'man
Ammonium	Ammonio
Session Initiation Protocol	Session Initiation Protocol
Salafiya	Salafismo
Berbera	Berbera
Botka internetka	Bot
Bergen op Zoom	Bergen op Zoom
Mengista Xayle Maryam	Menghistu Hailè Mariàm
Mowliidka Nebiga	Mawlid
Ciraaqi Diinaar	Dinaro iracheno
Adenoviridae	Adenoviridae
Daniel arap Moi	Daniel Toroitich arap Moi
Nabi Huud	Hud (profeta)
Ne-Yo	Ne-Yo
Sin	Anca
Rajab	Rajab
Axmed Binu Xambal	Ahmad ibn Hanbal
Sheybaar	Microscopio
Peso (Arjantiina)	Peso argentino
Yamanta Koonfureed	Repubblica Democratica Popolare dello Yemen
Assur	Assur (sito archeologico)
Decimetre	Decimetro
Sean paul	Sean Paul
Calanka somaliland	Bandiera del Somaliland
Soomaali Galbeed	Regione dei Somali
Shilin Kiinyaati	Scellino keniota
Astaannta Qaranka ee Soomaaliya	Stemma della Somalia
Astaannta Qaranka ee Imaaraatka	Stemma degli Emirati Arabi Uniti
Federaaliisim	Federalismo
Biomolikule	Biomolecola
Nabi Alyasac C.S.	Eliseo (profeta)
Birr	Birr etiope
Jaad	Catha edulis
Cows	Prato rasato
S-block	Elementi del blocco s
Dab Damis	Autopompa
SliTaz	SliTaz
Maxamed Siyaad Barre	Mohammed Siad Barre
Salo	Salo
Ívi Adámou	Īvī Adamou
Cafar	Afar (popolo)
Saliid Macsaro	Olio di semi di sesamo
Cumar Mukhtaar	Omar al-Mukhtar
Seey	Marito
Angalool	Conchiglia
Flo Rida	Flo Rida
Eden Hazard	Eden Hazard
T.I.	T.I.
Budhcad badeeda geeska afrika	Pirateria somala
Ayaan Xirsi Cali	Ayaan Hirsi Ali
P-block	Elementi del blocco p
F-block	Metalli del blocco f
Cabdullaahi Yuusuf Axmed	Abdullahi Yusuf Ahmed
Ururka Dawladaha aan la aqoonsan Wali	Organizzazione delle nazioni e dei popoli non rappresentati
Qof	Persona (filosofia)
Darawal	Chauffeur
Addimo-yaqaan	Ortopedia
Dhul (dhulka lagu socdo)	Pavimento
Faysal Bin Cabdil Caziiz	Faysal dell'Arabia Saudita
Wadar	Sommatoria
Qormo saynis	Notazione scientifica
C.H	BC
Adam Levine	Adam Levine
Al-Faatixa	Al-Fātiḥa
Al-Baqara	Al-Baqara
Hogaamiye Kooxeed	Signore della guerra
T-pain	T-Pain
Anggun	Anggun
Carlos the Jackal	Ilich Ramírez Sánchez
Fatima	Fatima
Mombaaso	Mombasa
Alexa Internet	Alexa
Sheekh Xasan Albanaa	Hasan al-Banna
Daariq ibn Ziyaad	Tariq ibn Ziyad
Seed	Tendine
Al-Ikhlas	Al-Ikhlāṣ
Suurad	Sura
Xadiis	Hadíth
Sunna	Sunna
Allaah	Allah
Salaad	Ṣalāt
Xaj	Hajj
Malag	Angelo
Astaannta Qaranka ee Kolombiya	Stemma della Colombia
Xisbiga shacabka iyo xoriyada Holalnd	Partito Popolare per la Libertà e la Democrazia
Qeshm	Qeshm
Bukhaari	Bukhari
Dadka Soomaaliyeed	Somali (gruppo etnico)
Haumea	Haumea
Dagaalkii sokeeye ee Soomaaliya	Guerra civile in Somalia
Jason Derulo	Jason Derülo
Macrakadii Ceyn Jaaluut	Battaglia di Ayn Jalut
Akkad	Akkad (disambigua)
FIFA	Fédération Internationale de Football Association
Uumi	Vapore
Iman model	Iman (modella)
Amina bint Wahb	Amina bint Wahb
Maryama al-Qibtiyya	Marya al-Qibtiyya
Xafsa bint Cumar	Hafsa bint Umar
Laf	Osso
Wayne Rooney	Wayne Rooney
Al Hudaydah	Al-Hudayda
Sheekh Shariif Axmed	Sharif Sheikh Ahmed
Kismaayo	Chisimaio
Beydaan	Terminalia catappa
R. Kelly	R. Kelly
Fool	Incisivo
Lacey Duvalle	Lacey Duvalle
Jaamacada Ummada Soomaaliyeed	Università nazionale somala
Saaxil	Saaxil
Dhul Udug	Paese di Punt
Bakool	Bakool
Nabi Yacquub C.S.	Giacobbe
Mariana Ximenes	Mariana Ximenes
Zubeyr bin Cawaam R.C	Al-Zubayr ibn al-Awwam
Imaam Nawawi	Al-Nawawi
Imaamu Shaafici	Muhammad ibn Idris al-Shafi'i
Demba Ba	Demba Ba
Xasan Guuleed Abtidoon	Hassan Gouled Aptidon
K'naan	K'naan
Greyson Chance	Greyson Chance
Cabdul-Qadir Jilani	Abd al-Qadir al-Gilani
Cabdi Bile Cabdi	Abdi Bile
Cabdiqaasim Salaad Xassan	Abdiqasim Salad Hassan
Cabdirashiid Cali Sharma'arke	Abdirashid Ali Shermarke
Al-Shabaab	Al-Shabaab
Al Mahwit	Al Mahwit
Al Mukalla	Al-Mukalla
Sheekh Yaasir Al-Xabiib	Yasser Al-Habib
Imaam Maalik	Malik ibn Anas
Cody Simpson	Cody Simpson
Madfac	Granata (arma)
Dagaalkii xoraynta ogaden	Guerra dell'Ogaden
Oromo	Oromo
Xasan Sheekh Maxamuud	Hassan Sheikh Mohamud
Rodolfo Graziani	Rodolfo Graziani
Maxamed Faarax Caydiid	Mohammed Farah Aidid
Biyo baxa deg dega ah	Eiaculazione precoce
Dhulka Talyaaniga ee Soomaaliya	Somalia Italiana
Saytuun	Psidium
Trey songz	Trey Songz
Macawiis	Sarong
Nuuraddin Faarax	Nuruddin Farah
Compaq	Compaq
Nabi Saalax	Salih
Unimog	Unimog
Nabi Idriis	Idris (islam)
Tooreey	Lama (oggetto)
Boosaaso	Bosaso
Dowladda federaalka kumeelgaarka	Governo federale di transizione
Nabi Dulkifli	Dhu l-Kifl
Abu Bakr	Abū Bakr
Abuu Sufyaan	Abu Sufyan
Imaam Axmed Guray	Ahmad ibn Ibrihim al-Ghazi
IHH	Insani Yardim Vakfi
Dun	Thread
Cadale	Adale
Daahir Rayaale Kaahin	Dahir Riyale Kahin
Timo Soini	Timo Soini
Cali maxamed Geedi	Ali Mohammed Ghedi
Marek Grechuta	Marek Grechuta
Jeddah	Gedda (Arabia Saudita)
Shukaansi	Corteggiamento
Sacad bin Abii Waqaas	Sa'd ibn Abi Waqqas
Afdhere Jama	Afdhere Jama
Afgooye	Afgoi
Afmadow	Afmadù
Xulka Qaranka Soomaaliya	Nazionale di calcio della Somalia
Woqooyi bari	Provincia Nordorientale (Kenya)
Cabdullaahi bin Cabbaas	Abd Allah ibn 'Abbas
Masjid al-Aqsa	Moschea al-Aqsa
Dadka Tigriga	Tigrini
Computer Engineering	Ingegneria informatica
Masjid al-Xaram	Al-Masjid al-Haram
Taabici	Seguaci
Caluula	Alula (Somalia)
Nuur Xasan Xuseen	Nur Hassan Hussein
Astaanta Calanka Soomaaliya	Somaliyaay toosoo
Amxaaro	Amhara (popolo)
Rayhana bint Zayd	Rayhana bint Zayd
Ta'izz	Ta'izz
Murgacasho	Distorsione (medicina)
Calooleey	Trippa
Maxamed Xaaji Ibraahim Cigaal	Mohamed Ibrahim Egal
Aamina	Amina
Paramore	Paramore
Tuur	Cifosi
Lafdhabar	Colonna vertebrale
Luís Carlos Almeida da Cunha	Luís Carlos Almeida da Cunha
Paris Saint-Germain FC	Paris Saint-Germain Football Club
Ahlu sunno waljamaaca	Sunnismo
Puntland	Puntland
Qureysh	Quraysh
Masjidka Nabiga	Moschea del Profeta
Dagaalkii uxud	Battaglia di Uhud
Sambuus	Samosa
Imaam Mujtahid Sheykhul-Islaam	Ibn Taymiyya
Bilaal ibn Ribaax	Bilal
Fiat 124	Fiat 124
Busteejo	Autostazione
Galatasaray SK	Galatasaray Spor Kulübü
IGAD	Autorità intergovernativa per lo sviluppo
Baydhabo	Baidoa
G-Spot	Punto G
Xiriirka Soomaaliyeed ee Kubadda Cagta	Federazione calcistica della Somalia
Naxariis iyo Nabadgelyo Korkiisa Ha Ahaato	Pbsl
Sayid Maxamed Cabdulle Xassan	Mohammed Abdullah Hassan
Salmaan Alfaarisi	Salman al-Farisi
Sheekh Maxamed Naasiruddiin Al-Albaani	Muhammad Nasir al-Din al-Albani
Salaada Magrib	Maghrib
Mareeg	Meregh
Baskin-Robbins	Baskin-Robbins
Haparanda	Haparanda
Xarardheere	Harardera
Baraawe	Brava (Somalia)
Xisbiga Hantiwadaagga Kacaanka Soomaaliyeed	Partito Socialista Rivoluzionario Somalo
Dhuusamareeb	Dusa Mareb
Karkaar	Karkaar
Jowhar	Giohar
Marka	Merca
Biciid	Oryx
Hiiraan	Hiran
Astaannta Qaranka ee somaliland	Stemma del Somaliland
Dhulka Biritishka ee Soomaaliya	Somalia Britannica
Nabi Isxaaq C.S.	Isacco
Soomaaliweyn	Grande Somalia
Zamenhof	Zamenhof
Shabeellaha Dhexe	Medio Scebeli
Cabdi Faarax Shirdoon	Abdi Farah Shirdon Saaid
Hanti maguurto	Bene immobile
Jalalaqsi	Gialalassi
Liiska dalalka dad ahaan	Stati per popolazione
Godol	Lattazione
Mr. Lordi	Mr. Lordi
Bari (Gobol)	Bari (Somalia)
Wajeer	Wajir
Adult Film Database	Adult Film Database
Cali Mahdi Maxamed	Ali Mahdi Mohamed
Midowga Maxkamadaha Islaamiga	Unione delle corti islamiche
Somaliland shilling	Scellino del Somaliland
Taleefoonada fiilada	Telefonia fissa
UNICEF	Fondo delle Nazioni Unite per l'infanzia
Behra	Dorcatragus megalotis
Godeey	Gode
Abuu Cubeydah Caamir ibn Jaraax	Abu Ubayda ibn al-Jarrah
Sanaag	Sanag
Jigjiga	Giggiga
Salaada Casir	Salat al-'asr
Centro Federal de Educação Tecnológica Celso Suckow da Fonseca	Centro Federal de Educação Tecnológica Celso Suckow da Fonseca
Salaada Cishe	Al-'Isha'
Garoonka Diyaaradaha ee Da Nang	Aeroporto Internazionale di Da Nang
Cirbadii dhimashada	Leiurus quinquestriatus
Nansi Ajram	Nancy Ajram
Qaasim bin Muxamed	Al-Qasim ibn Muhammad
Awdal	Adal
Awdheegle	Audegle
Baardheere	Bardera
Badhan	Baran (Somalia)
Jasiiradaha Jubbada Hoose	Isole Giuba
Baki	Baki (Somalia)
Banaadir	Benadir
Baargaal	Bargal
Bari	Bari (disambigua)
Baay	Bai (Somalia)
Sedjibeke	Cubo
Beledweyne	Belet Uen
Garoowe	Garoe
Derg	Derg
Kilometer	Chilometro
Xaawo	Eva
Dhuun	Faringite streptococcica
Web feed	Feed
Salaada Duhur	Zuhr
YouPorn	YouPorn
Liiska magaalooyinka adduunka dad ahaan	Città del mondo per popolazione
Guraag	Guraghé (popolo)
Hectometre	Ettometro
Eurobeat	Eurobeat
Decametre	Decametro
Sool	Sol (Somalia)
York University	York University
Gedo	Ghedo
Gaalkacyo	Gallacaio
Guddi	Comitato (collegio)
Togdheer	Tug Dair
Goobogali	Scelta multipla
Galguduud	Galgudud
Woqooyi Galbeed	Nordovest (Somalia)
Shabeellaha Hoose	Basso Scebeli
Mudug	Mudugh
Jubbada Hoose	Basso Giuba
Saxiixu Muslim	Sahih Muslim
Boorama	Borama
Taran	Produttoria
Reoviruses	Reoviridae
Wikipedia:Caawinaad	Aiuto:Aiuto
Wikipedia:Tutorial	Aiuto:Tour guidato
Miraha Mucjisada	Synsepalum dulcificum
Pontifícia Universidade Católica de Minas Gerais	Pontifícia Universidade Católica de Minas Gerais
Galmudug	Galmudugh
Canjeelo	Enjera
Pornhub	PornHub
USC	Congresso della Somalia unita
Sunanka Abii Daawuud	Sunan Abu Dawud
Dawladii Mamaaliikta	Mamelucchi
Poxviruses	Poxviridae
Digri	Dhikr
Burco	Burao
Ajdjadajd	Oltregiuba
Mandheera	Mandera
Sagaaro	Madoqua piacentinii
Nabi Shuceyb	Shu'ayb
Warshiikh	Uarsceik
Hobyo	Obbia
Jamaame	Giamama
Xudur	Oddur
Doolow	Dolo (Somalia)
Garbahaarey	Garba Harre
Murshid abad	Murshidabad
Ceerigaabo	Erigavo
Galdogob	Galdogob
Iskushuban	Scusciuban
Xaafuun	Hafun
Laascaanood	Las Anod
Laasqoray	Las Gorei
Buuloburde	Bulo Burti
Buurhakaba	Bur Acaba
Eyl	Eil
Saxiixul Bukhaari	Sahih al-Bukhari
Shiilaabo	Scilave
Abuu Dar Alghafaari	Abu Dharr al-Ghifari
Calool	Stomaco
Jubbada Dhexe	Medio Giuba
Nugaal	Nogal (Somalia)
Internet Adult Film Database	Internet Adult Film Database
Ceres	Ceres
Lambar Tubaxan	Sistema numerico ternario
Layli goobalay	Layli Goobalay
Dagaalkii (2006–2009)	Guerra in Somalia
Ciidamada Qalabka Sida ee Masaarida	Forze armate egiziane
Dadka Tigrega	Tigrè (popolo)
Milme	Soluto
26 Juun 1960	Stato del Somaliland
Garoonka Diyaaradaha ee Aadan Cadde	Aeroporto Internazionale Aden Adde
Liverpool FC	Liverpool Football Club
Xariiqanta Cagaaran	Linea Verde (Israele)
Duurjoog	Humbug (album)
Xtube	Xtube
Raas Caseyr	Capo Guardafui
Sacad bin Zeyd	Sa'ìd b. Zayd
GCompris	GCompris
Mucaad Bin Jabal	Mu'adh ibn Jabal
Jacfar Bin Abii Daalib	Ja'far ibn Abi Talib
Cabdullahi binu xudeyfa al sahamiyi	Abd Allah ibn Hudhafa al-Sahmi
Makemake	Makemake
Saynab bint Muxamed	Zaynab bint Muhammad
Wikipedia:Safaarad	Wikipedia:Ambasciata
Naafto	Diesel
U qeybin	Divisione (matematica)
Samuel Eto'o	Samuel Eto'o
RedTube	RedTube
Shabiixa	Shabiha
Maakhir	Maakhir
Ra'iisul wasaarayaashii Soomaaliya	Primi ministri della Somalia
Qurac	Acacia tortilis
Garoonka Diyaaradaha ee Bender Qaasim	Aeroporto internazionale di Bosaso
Agnes Monica	Agnes Monica
Xuseen Maxamed Faarax Caydiid	Hussein Farrah Aidid
Cali Khaliif Galayr	Ali Khalif Galaid
Category:Jarmal	Categoria:Germania
Category:Talyaaniga	Categoria:Italia
Category:Qaramada Midoobey ee Maraykanka	Categoria:Stati Uniti d'America
Category:Ruushka	Categoria:Russia
Category:Midowga boqortooyada Britan	Categoria:Regno Unito
Category:Isbania	Categoria:Spagna
Category:Shiinaha	Categoria:Cina
Category:Hindiya	Categoria:India
Category:Sucuudiga	Categoria:Arabia Saudita
Category:Turki	Categoria:Turchia
Category:Koonfur Afrika	Categoria:Sudafrica
Category:Masar	Categoria:Egitto
Category:Iiraan	Categoria:Iran
Category:Arjantiina	Categoria:Argentina
Wanlaweyn	Uanle Uen
Category:Afqaanistan	Categoria:Afghanistan
Category:Austriya	Categoria:Austria
Category:Itoobiya	Categoria:Etiopia
Category:Ciraaq	Categoria:Iraq
Category:Nederland	Categoria:Paesi Bassi
Category:Bakistaan	Categoria:Pakistan
Category:Boland	Categoria:Polonia
Category:Bortuqaal	Categoria:Portogallo
Category:Suudaan	Categoria:Sudan
Category:Iswisarland	Categoria:Svizzera
Category:Fiyetnam	Categoria:Vietnam
Category:Shimbir	Categoria:Uccelli
Category:Fiisikis	Categoria:Fisica
Category:Bayoloji	Categoria:Biologia
Category:Kimisteri	Categoria:Chimica
Category:Taariikh	Categoria:Storia
Category:Juqraafi	Categoria:Geografia
Category:Diin	Categoria:Religione
Category:Ciyaaraha	Categoria:Sport
Category:Saynis	Categoria:Scienza
Category:Filimaanta	Categoria:Cinema
Category:Isgaadhsiin	Categoria:Comunicazione
Jamhuuriyadda Dimuqraadiga Soomaaliya	Repubblica Democratica Somala
Jilib	Gelib
Hawd	Haud
Hawiye	Hauia
Railway Mogadiscio-Villabruzzi	Ferrovia Mogadiscio-Villaggio Duca degli Abruzzi
Peso Argentino	Peso argentino (1983)
Qardho	Gardo
Ciidamada Midowga Afrika	Missione dell'Unione africana in Somalia
Cabdiraxmaan bin Cawf	Abd al-Rahman ibn Awf
Dalxa bin Cubeydilah R.C.	Talha ibn Ubayd Allah
Qandala	Candala
Janaale	Genale
Ras kambooni	Ras Chiambone
Submission (film)	Submission (film 2004)
Cabdiweli Maxamed Cali	Abdiweli Mohamed Ali
Laas Geel	Laas Gaal
Luuq	Lugh
Muxaram	Muharram
Category:Filasoofiyada	Categoria:Filosofia
Category:Cilminafsi	Categoria:Psicologia
Category:Masiixiyad	Categoria:Cristianesimo
Category:Islaam	Categoria:Islam
Goronyo soomaaliyeed	Struthio molybdophanes
Beled-Xaawo	Beled Hawo
Qoryooley	Coriolei
Ufeyn	Ufein
Jirriiban	Geriban
Balcad	Balad (Somalia)
Waajid	Uegit
Ceelaayo	Elaayo
PornoTube	PornoTube
Ramla bint Abi Sufyan	Ramla bint Abi Sufyan
10-ka saxaabi ee Janada loogu bishaareeyay iyagoo nool	Dieci Benedetti
Abgaal	Abgal (etnia)
Jaamacadda Roma Tre	Università degli Studi Roma Tre
Ruqiya bint Muxamed	Ruqayya
Kobra	Cobra
Saldanadii Cadal	Sultanato di Adal
Cabdulaahi Muxamed	Abd Allah ibn Muhammad (figlio di Maometto)
Umm Kaltuum bint Muxamed	Umm Kulthum bint Muhammad
Nabi Yuunus C.S.	Giona (profeta)
Dad	Popolo
Xiriirka Soomaaliyeed ee Kubadda koleyga	Nazionale di pallacanestro della Somalia
Abdal-Xamiid Kishk	ʿAbd al-Ḥamīd Kishk
Universidade do Estado de Minas Gerais	Universidade do Estado de Minas Gerais
Mici	Canino superiore
Feedh	Gabbia toracica
Ciidanka Soomaaliya	Esercito nazionale somalo
Khaatumo state	Khatumo
Bianca Castanho	Bianca Castanho
Bander Beyla	Bender Beila
Ceelbuur	El Bur
Boqor Najaashi	Aṣḥama ibn Abjar
Laan	Ramo
Category:Dhaqan	Categoria:Cultura
Category:Tobaneeyada sano	Categoria:Decenni
Category:Sanad	Categoria:Anni
Category:Qaaradaha	Categoria:Continenti
Sheikh Mukhtar Mohamed Hussein	Mukhtar Mohamed Hussein
Degmooyinka arjentiin	Suddivisioni dell'Argentina
Radio Muqdisho	Radio Mogadiscio
Fiat 682 N3	Fiat 682
Portal:Cilmi Fallag	Portale:Astronomia
Portal:Juqraafi	Portale:Geografia
Gunbur	Piramide (geometria)
Jano	Paradiso
Turunbo	Tanbur
Saami qumman	Rapporto
Ibraahim bin Muxamed	Ibrahim ibn Muhammad
Tiro	Conte
Anna Rita Del Piano	Anna Rita Del Piano
XVideos	XVideos
Dagaal Dhaqameedka shiineeska	Arti marziali cinesi
Ceelwaaq	El Uach
Habargidir	Habr Ghedir
Hurdiya	Hordio
Cufka atamka	Peso atomico
Mahadaay Weyn	Mahaddei Uen
Hotmail	Windows Live Hotmail
Wikipedia:Su'aal/Hordhac	Wikipedia:Oracolo
Wikipedia:Graphics Lab	Progetto:Laboratorio grafico
Tiyeegloow	Tigieglò
Tooxin	Tohen
Category:Wadamada	Categoria:Nazioni
Wikipedia:Maamulka	Wikipedia:Amministratori
Category:Shaqsiyadaad	Categoria:Persone
Wikipedia:Requests for adminship	Wikipedia:Amministratori/Candidati
Wikipedia:Bots	Wikipedia:Bot
Category:Amin	Categoria:Tempo
Category:Internet	Categoria:Internet
Category:Siyaasad	Categoria:Politica
Category:Waxbarasho	Categoria:Educazione
Category:Araga	Categoria:Ottica
Category:Fan	Categoria:Arte
Masar	Egitto
Category:Filasoofiyaasha	Categoria:Filosofi
Category:Doorashooyinka	Categoria:Elezioni
Template:Bot	Template:Bot
Kanada	Canada
Category:Denmark	Categoria:Danimarca
Category:Giriig	Categoria:Grecia
Category:Iswiidhan	Categoria:Svezia
Category:Islofaakiya	Categoria:Slovacchia
Wikipedia:Copyright	Wikipedia:Copyright
Wikipedia:Ku saabsan	Wikipedia:Sala stampa/Wikipedia
Category:Dagaalada	Categoria:Guerre
Category:Microsoft	Categoria:Microsoft
Portal:Saynis	Portale:Scienza e tecnica
Wikipedia:Ogaysiiska Maamulka	Wikipedia:Richieste agli amministratori
Category:Wadamada Yurub	Categoria:Stati dell'Europa
Category:Yurub	Categoria:Europa
Wikipedia:Bogga Isticmaalaha	Wikipedia:Pagina utente
Template:Documentation	Template:Man
Category:Delete	Categoria:Cancellazioni
Wikipedia:Ilaalinta badelka	Wikipedia:Politica di protezione delle pagine
Wikipedia:Albaabka bulshada	Portale:Comunità
Category:Luqadaha wikipediyaasha	Categoria:Utenti per lingua
Wikipedia:Shan walxood	Wikipedia:Cinque pilastri
Wikipedia:Userboxes	Wikipedia:Info utente
Wikipedia:Saxiix	Aiuto:Firma
Sung Jae-ki	Sung Jae-gi
Caa'isha binti Abiibakar	Aisha
Ganacsi	Business
Instituto Federal da Bahia	Istituto federale di Bahia
Template:Softredirect	Template:Soft redirect
Template:Tirtir	Template:Cancella subito
Qaw	Bender Ziada
Category:Teknooloji	Categoria:Tecnologia
Category:Afafka	Categoria:Lingue
Category:Kalandar	Categoria:Calendari
Category:Wikipedia	Categoria:Wikipedia
Wikipedia:Masuul la'aan guud	Wikipedia:Avvertenze generali
Category:Pages with broken file links	Categoria:Pagine con link a file inesistenti
Wikipedia:Xeerka Wiki	Wikipedia:Politica relativa alla privacy
Template:Navbox	Template:Navbox
Template:Xaqiiq	Template:Citazione necessaria
Portal:Siiro	Portale:Biografie
Template:Tnavbar	Template:Tnavbar
Template:Clear	Template:Clear
Template:Nowrap	Template:Tutto attaccato
Faisal Aden	Faisal Aden
Millan	Soluzione (chimica)
Wikipedia:Maqaalada aan u baahan laheen	Wikipedia:Lista delle voci che tutte le Wikipedie dovrebbero avere
Category:Afrika	Categoria:Africa
Category:Elektaroonig	Categoria:Elettronica
Category:Kitaabka quduska	Categoria:Bibbia
Category:Buugta	Categoria:Libro
Category:Bilaha	Categoria:Mesi dell'anno
Template:Babel	Template:Babel
Template:Reflist	Template:References
Category:Isbitaal	Categoria:Ospedali
Wikipedia:Soo bandhigida xogta	Aiuto:Uso delle fonti
Wikipedia:Habka maqaalada Xulka Ah	Wikipedia:Vetrina/Criteri
Template:Gumud	Template:S
Template:User ar-1	Template:Utente ar-1
Template:See also	Template:Vedi anche
Template:User da-2	Template:Utente da-2
Template:User da	Template:Utente da
Template:User de	Template:Utente de
Template:User de-1	Template:Utente de-1
Template:User es	Template:Utente es
Template:User de-3	Template:Utente de-3
Template:User en-3	Template:Utente en-3
Template:User en-1	Template:Utente en-1
Template:User en-2	Template:Utente en-2
Template:User en-4	Template:Utente en-4
Template:User fi	Template:Utente fi
Template:User en-0	Template:Utente en-0
Template:User en	Template:Utente en
Template:User de-2	Template:Utente de-2
Template:User fi-1	Template:Utente fi-1
Template:User fr-1	Template:Utente fr-1
Template:User sk	Template:Utente sk
Template:User fr-2	Template:Utente fr-2
Template:User ja	Template:Utente ja
Template:User ja-1	Template:Utente ja-1
Template:User fr	Template:Utente fr
Ayeeyo	Granny
Category:Aasiya	Categoria:Asia
Category:Jili	Categoria:Cile
Category:Ameerikada koonfureed	Categoria:America meridionale
Template:Intricate template	Template:Template complesso
Template:Mod	Template:Mod
Template:User es-2	Template:Utente es-2
Category:Maalmaha usbuuca	Categoria:Giorni della settimana
Category:Bogga Hore	Categoria:Pagina principale
Template:Number of defined parameters	Template:Numero di parametri definiti
Template:Image label	Template:Etichetta immagine
Template:Dalalka Afrika	Template:Africa
Template:Sidebar	Template:Sidebar
Wikipedia:Tutorial (Wikipedia links)	Aiuto:Tutorial/Link
Template:Maqaal Xul Ah	Template:Vetrina
Category:Gaana	Categoria:Ghana
Category:User en	Categoria:Utenti en
Category:User en-2	Categoria:Utenti en-2
Template:Infobox	Template:Infobox
Template:Navy	Template:Insegna navale
Template:User eo	Template:Utente eo
Template:User zh	Template:Utente zh
Category:Farta	Categoria:Alfabeti
Template:Pp-template	Template:Pp-template
Template:Min	Template:Min
Category:Astaannta Qaranka	Categoria:Stemmi
Category:Beeraha	Categoria:Agricoltura
Category:Dowladaha	Categoria:Stato
Category:Bahda Midaysay Qoraxdu	Categoria:Pianeti del sistema solare
Category:Falastiin	Categoria:Palestina
Category:Language user templates	Categoria:Template Babel
Template:Navbox subgroup	Template:Navbox subgroup
Template:Farac	Template:Popolo
Template:Category redirect	Template:Categoria redirect
Template:Macluumaad Qof Madax Ah	Template:Carica pubblica
Category:Kacaanka	Categoria:Rivoluzionari
Template:Border	Template:Border
Category:Qoraaga	Categoria:Scrittori
Category:Jaamacadaha	Categoria:Università
Wikipedia:Maxaan akoon usamaynayaa	Aiuto:Nome utente
Template:Hidden begin	Template:Cassetto inizio
Template:User pt-1	Template:Utente pt-1
Template:User nl	Template:Utente nl
Template:Infobox website	Template:Sito web
Template:Image label end	Template:Etichetta immagine fine
Template:Infobox number	Template:Numero intero
Category:Dekedaha	Categoria:Porti
Template:Lang-la	Template:Latino
Template:Macluumaad askariga	Template:Infobox militare
Template:User	Template:Utente
Template:References	Template:F
Template:Jadwal	Template:Prettytable
Template:PD-because	Template:PD-Perché
Template:Infobox former country	Template:Stato storico
Template:Kaydka wadahadalka	Template:Avviso archivio
Portal:Fiisikis	Portale:Fisica
Template:User de-0	Template:Utente de-0
Template:Usbuuc	Template:Giorni della settimana
Template:User fr-0	Template:Utente fr-0
Template:Largest cities	Template:Città principali
Template:Hidden end	Template:Cassetto fine
Category:Booliis	Categoria:Polizia
Template:Astaamayn	Template:Punteggiatura
Template:Country data Ukrain	Template:Naz/UKR
Template:User pt-0	Template:Utente pt-0
Template:Higgaad	Template:Correggere
Template:User pt-2	Template:Utente pt-2
Category:User sk	Categoria:Utenti sk
Category:User eo	Categoria:Utenti eo
Category:User ja	Categoria:Utenti ja
Category:User da-2	Categoria:Utenti da-2
Template:Correct title	Template:Titolo errato
Category:User ar	Categoria:Utenti ar
Category:Jasiirad	Categoria:Isole
Category:User da	Categoria:Utenti da
Category:User sk-N	Categoria:Utenti sk-M
Category:User de	Categoria:Utenti de
Category:User fi	Categoria:Utenti fi
Category:Nabiyada Islaamka	Categoria:Profeti islamici
Category:Tiirarka Islaamka	Categoria:Cinque pilastri dell'Islam
Category:User ja-1	Categoria:Utenti ja-1
Category:User ko	Categoria:Utenti ko
Template:Macluumaad	Template:Informazioni file
Wikipedia:Babel	Wikipedia:Babel
Category:Abwaanada	Categoria:Poeti
Category:Badaha	Categoria:Mari
Category:Ingiriiska	Categoria:Inghilterra
Template:Str ≥ len	Template:Str ≥ len
Category:Taariikhda Soomaaliya	Categoria:Storia della Somalia
Category:Ururada caalamiga ah	Categoria:Organizzazioni internazionali
Category:Gobolada Soomaaliya	Categoria:Regioni della Somalia
Category:Juquraafiga Soomaaliya	Categoria:Geografia della Somalia
Category:Cilmiga bulshada	Categoria:Scienze sociali
Category:Wadamada Afrika	Categoria:Stati dell'Africa
Template:User da-3	Template:Utente da-3
Category:User so	Categoria:Utenti so
Category:User so-N	Categoria:Utenti so-M
Category:1542	Categoria:Eventi del 1542
Fenerbahce SK	Fenerbahçe Spor Kulübü
Universidade Federal do Recôncavo da Bahia	Università federale di Recôncavo da Bahia
Category:Farshaxanka	Categoria:Pittori
Wikipedia:Xeerka adeegsiga sawirada	Wikipedia:Copyright immagini
Template:Raadiyoow	Template:Canale radio
Wikipedia:Habaynta Maqaalada Cusub	Wikipedia:Voci di qualità/Riesame
Category:Dhirta	Categoria:Alberi
Portal:Baayooloji	Portale:Biologia
Category:Juquraafiga Hindiya	Categoria:Geografia dell'India
Category:Jabuuti	Categoria:Gibuti
Category:Ereteriya	Categoria:Eritrea
Category:Kiinya	Categoria:Kenya
Category:Komoros	Categoria:Comore
Category:Libiya	Categoria:Libia
Category:Diinta Soomaaliya	Categoria:Religione in Somalia
Category:Dhaqaalaha Soomaaliya	Categoria:Economia della Somalia
Category:Lacagta	Categoria:Valute
Category:Webiyada	Categoria:Fiumi
Category:Juquraafiga Jabuuti	Categoria:Geografia di Gibuti
Template:User pt	Template:Utente pt
Category:Holland	Categoria:Olanda
Category:Soomaaliya	Categoria:Somalia
Category:Webiyada Soomaaliya	Categoria:Fiumi della Somalia
Category:Juquraafiga Yemen	Categoria:Geografia dello Yemen
Category:Magaalooyinka Yemen	Categoria:Città dello Yemen
Category:User nl	Categoria:Utenti nl
Category:Hay'ada laanqayrta cas	Categoria:Croce Rossa
Template:Navbar-header	Template:Tnavbar-header
Category:Suuriya	Categoria:Siria
Category:Qarniyada	Categoria:Secoli
Category:Qarnigii 16aad	Categoria:XVI secolo
Category:Filasoofiyaasha Jarmalka	Categoria:Filosofi tedeschi
Category:Ciidanka Soomaaliya	Categoria:Forze armate somale
Category:Esoteric templates	Categoria:Template complessi
Category:Harraha Afrika	Categoria:Laghi dell'Africa
Category:Madaxda Faransiiska	Categoria:Presidenti della Repubblica francese
Category:Madaxda Iiraan	Categoria:Presidenti dell'Iran
Category:Norway	Categoria:Norvegia
Category:Yemen	Categoria:Yemen
Category:Malaay	Categoria:Pesci
Category:Mutolojiyada	Categoria:Mitologia
Category:Qaamuus	Categoria:Dizionari
Category:Axdiga Cusub	Categoria:Nuovo Testamento
Category:Ilko	Categoria:Denti
Category:Dhaqanka Soomaalida	Categoria:Cultura della Somalia
Category:Wikimedia	Categoria:Wikimedia Foundation
Category:Radio	Categoria:Radio
Category:Xayawaan	Categoria:Animali
Category:Kushiinka Soomaalida	Categoria:Cucina somala
Category:Muqdisho	Categoria:Mogadiscio
Category:Bartamaha Ameerika	Categoria:America centrale
Category:Caasimadaha	Categoria:Capitali di stato
Category:Magaalooyinka Hindiya	Categoria:Città dell'India
Category:Isgaarsiinta	Categoria:Telecomunicazioni
Category:Gaadiidka	Categoria:Trasporti
Category:Ameerikada waqooyi	Categoria:America settentrionale
Category:Harraha	Categoria:Laghi
Category:Saxaabada	Categoria:Sahaba
Category:Calamada	Categoria:Bandiere
Template:Macluumaad luqadda	Template:Lingua
Category:Dimoqraadi	Categoria:Democrazia
Kaaroot	Daucus carota
Template:Gobolada Soomaaliya	Template:Regioni della Somalia
Category:Komunistiyaasha Jarmalka	Categoria:Comunisti in Germania
Category:Geeska Afrika	Categoria:Corno d'Africa
Category:Guurka	Categoria:Matrimonio
Template:So	Template:So
Category:Lahjadaha looga hadlo Soomaaliya	Categoria:Lingue della Somalia
Category:Somaliland	Categoria:Somaliland
Category:Caafimaadka	Categoria:Salute
Template:Flag	Template:Bandiera
Template:Lang-pl	Template:Polacco
Category:Buuraha Soomaaliya	Categoria:Montagne della Somalia
Portal:Xisaab	Portale:Matematica
Trojany	Trojany
Template:HMXA	Template:Vetrina rimozione
Category:Wadamada Aasiya	Categoria:Stati dell'Asia
Portal:Siyaasadda	Portale:Politica
Portal:Qaynuun	Portale:Diritto
Category:Abidjan	Categoria:Abidjan
Tiirarka Iimaanka	Sei articoli di fede
Category:Antananarifo	Categoria:Antananarivo
Lug (xubin)	Gamba
Category:Bamako	Categoria:Bamako
Template:Colonne	Template:Colonne
Eray bixin	Terminologia
Category:Degmooyinka Soomaaliya	Categoria:Distretti della Somalia
Category:Esperanto	Categoria:Esperanto
Khilaafadii Umawiyiinta	Omayyadi
Portal:Kimistari	Portale:Chimica
Category:Linux	Categoria:Linux
Category:Siyaasada Soomaaliya	Categoria:Politica della Somalia
Category:Komunistiyaasha	Categoria:Comunisti
Category:Qiyaasaha Masaafooyinka	Categoria:Unità di lunghezza
Category:Midabada	Categoria:Colori
Category:Triboli	Categoria:Tripoli
Category:Jaamacadaha Soomaaliya	Categoria:Università in Somalia
Category:User nl-4	Categoria:Utenti nl-4
Category:Bahalada sheeko xariirka	Categoria:Sirene
Template:Image label begin	Template:Etichetta immagine inizio
Category:Suuradaha Qur'aanka	Categoria:Sure del Corano
Category:User en-1	Categoria:Utenti en-1
Category:Gacamada caalamka	Categoria:Golfi
Template:Turjumid	Template:T
Portal:Caafimaad	Portale:Medicina
Template:Afarta xilli	Template:Stagioni
Kalagoyn	Meno (matematica)
Wikipedia:Tutorial (Talk pages)	Aiuto:Tutorial/Discussione
Wikipedia:Tutorial (Keep in mind)	Aiuto:Tutorial/Linee guida
Template:User nl-3	Template:Utente nl-3
Template:Goob	Template:Bar3
Wikipedia:Tutorial (Registration)	Aiuto:Tutorial/Registrazione
Template:Efn	Template:Efn
Parvoviruses	Parvoviridae
Rooman	Acquedotto romano
Wikipedia:Editnotice	Wikipedia:Editnotice
Kim Cesarion	Kim Cesarion
Magaca Muuse	Mosè (nome)
Adnan Januzaj	Adnan Januzaj
Gobolada Soomaaliya	Regioni della Somalia
Cabdiweli Sheekh Axmed	Abdiweli Sheikh Ahmed
Barkhad Cabdi	Barkhad Abdi
Special:RecentChanges	Speciale:UltimeModifiche
Module:Navbox	Modulo:Navbox
XHamster	XHamster
Category:Wabiyada Afrika	Categoria:Fiumi dell'Africa
Madaxweyneyaashii Soomaaliya	Presidenti della Somalia
